patient|인내심있는|인내심있는,성급한,조급한,화난|TOEFL
impatient|조급한|조급한,인내심있는,차분한,여유로운|TOEFL
polite|예의바른|예의바른,무례한,거친,불친절한|TOEFL
rude|무례한|무례한,예의바른,친절한,공손한|TOEFL
honest|정직한|정직한,거짓말하는,속이는,부정직한|TOEFL
dishonest|부정직한|부정직한,정직한,진실한,올바른|TOEFL
generous|관대한|관대한,인색한,이기적인,욕심많은|TOEFL
selfish|이기적인|이기적인,관대한,친절한,배려하는|TOEFL
careful|조심스러운|조심스러운,부주의한,무모한,경솔한|TOEFL
careless|부주의한|부주의한,조심스러운,신중한,세심한|TOEFL
useful|유용한|유용한,쓸모없는,무익한,해로운|TOEFL
useless|쓸모없는|쓸모없는,유용한,가치있는,필요한|TOEFL
helpful|도움이되는|도움이되는,해로운,방해되는,무익한|TOEFL
harmful|해로운|해로운,유익한,도움되는,좋은|TOEFL
peaceful|평화로운|평화로운,폭력적인,시끄러운,혼란스러운|TOEFL
violent|폭력적인|폭력적인,평화로운,온화한,부드러운|TOEFL
powerful|강력한|강력한,약한,무력한,연약한|TOEFL
powerless|무력한|무력한,강력한,힘센,능력있는|TOEFL
painful|고통스러운|고통스러운,편안한,즐거운,기쁜|TOEFL
painless|고통없는|고통없는,고통스러운,아픈,괴로운|TOEFL
hopeful|희망찬|희망찬,절망적인,우울한,비관적인|TOEFL
hopeless|희망없는|희망없는,희망찬,낙관적인,기대되는|TOEFL
careful|신중한|신중한,무모한,경솔한,부주의한|TOEFL
thankful|감사하는|감사하는,불평하는,무례한,배은망덕한|TOEFL
successful|성공적인|성공적인,실패한,좌절한,패배한|TOEFL
unsuccessful|실패한|실패한,성공적인,승리한,잘된|TOEFL
comfortable|편안한|편안한,불편한,고통스러운,답답한|TOEFL
uncomfortable|불편한|불편한,편안한,안락한,쾌적한|TOEFL
wonderful|훌륭한|훌륭한,끔찍한,형편없는,나쁜|TOEFL
terrible|끔찍한|끔찍한,훌륭한,멋진,좋은|TOEFL
awful|끔찍한|끔찍한,훌륭한,멋진,좋은|TOEFL
cheerful|명랑한|명랑한,우울한,슬픈,음울한|TOEFL
colorful|화려한|화려한,무채색의,단조로운,칙칙한|TOEFL
beautiful|아름다운|아름다운,못생긴,추한,끔찍한|TOEFL
wonderful|멋진|멋진,끔찍한,나쁜,형편없는|TOEFL
excellent|훌륭한|훌륭한,형편없는,나쁜,끔찍한|TOEFL
perfect|완벽한|완벽한,불완전한,결함있는,나쁜|TOEFL
terrible|끔찍한|끔찍한,훌륭한,좋은,멋진|TOEFL
horrible|끔찍한|끔찍한,좋은,훌륭한,멋진|TOEFL
pleasant|즐거운|즐거운,불쾌한,괴로운,끔찍한|TOEFL
unpleasant|불쾌한|불쾌한,즐거운,기쁜,행복한|TOEFL
exciting|신나는|신나는,지루한,재미없는,따분한|TOEFL
boring|지루한|지루한,신나는,재미있는,흥미로운|TOEFL
interesting|흥미로운|흥미로운,지루한,재미없는,따분한|TOEFL
amazing|놀라운|놀라운,평범한,지루한,예상된|TOEFL
surprising|놀라운|놀라운,예상된,평범한,당연한|TOEFL
shocking|충격적인|충격적인,예상된,평범한,당연한|TOEFL
frightening|무서운|무서운,안전한,편안한,재미있는|TOEFL
terrifying|무서운|무서운,안전한,편안한,즐거운|TOEFL
relaxing|편안한|편안한,긴장되는,스트레스받는,힘든|TOEFL
tiring|피곤한|피곤한,활기찬,신나는,편안한|TOEFL
confusing|혼란스러운|혼란스러운,명확한,분명한,쉬운|TOEFL
embarrassing|당황스러운|당황스러운,자랑스러운,편안한,기쁜|TOEFL
disappointing|실망스러운|실망스러운,만족스러운,기쁜,훌륭한|TOEFL
satisfying|만족스러운|만족스러운,실망스러운,불만족스러운,나쁜|TOEFL
annoying|짜증나는|짜증나는,즐거운,기쁜,편안한|TOEFL
touching|감동적인|감동적인,지루한,무감동한,냉담한|TOEFL
moving|감동적인|감동적인,지루한,무감각한,차가운|TOEFL
leading|주요한|주요한,부차적인,사소한,마지막의|TOEFL
following|다음의|다음의,이전의,첫번째,마지막|TOEFL
living|살아있는|살아있는,죽은,무생물의,사라진|TOEFL
missing|없어진|없어진,있는,발견된,나타난|TOEFL
growing|자라는|자라는,줄어드는,죽어가는,사라지는|TOEFL
changing|변하는|변하는,고정된,불변의,영구적인|TOEFL
increasing|증가하는|증가하는,감소하는,줄어드는,사라지는|TOEFL
decreasing|감소하는|감소하는,증가하는,늘어나는,확대되는|TOEFL
rising|상승하는|상승하는,하락하는,떨어지는,내려가는|TOEFL
falling|하락하는|하락하는,상승하는,오르는,증가하는|TOEFL
developing|발전하는|발전하는,퇴보하는,악화되는,정체된|TOEFL
advanced|발전된|발전된,후진적인,낙후된,원시적인|TOEFL
backward|후진적인|후진적인,발전된,진보적인,선진적인|TOEFL
forward|앞으로의|앞으로의,뒤로의,후진하는,퇴보하는|TOEFL
upward|위로향한|위로향한,아래로향한,수평의,정지한|TOEFL
downward|아래로향한|아래로향한,위로향한,올라가는,상승하는|TOEFL
inward|안쪽으로|안쪽으로,바깥쪽으로,밖으로,떨어진|TOEFL
outward|바깥쪽으로|바깥쪽으로,안쪽으로,안으로,중심으로|TOEFL
northern|북쪽의|북쪽의,남쪽의,동쪽의,서쪽의|TOEFL
southern|남쪽의|남쪽의,북쪽의,동쪽의,서쪽의|TOEFL
eastern|동쪽의|동쪽의,서쪽의,북쪽의,남쪽의|TOEFL
western|서쪽의|서쪽의,동쪽의,북쪽의,남쪽의|TOEFL
central|중앙의|중앙의,변두리의,외곽의,먼|TOEFL
upper|위쪽의|위쪽의,아래쪽의,중간의,바닥의|TOEFL
lower|아래쪽의|아래쪽의,위쪽의,꼭대기의,높은|TOEFL
inner|내부의|내부의,외부의,바깥쪽의,먼|TOEFL
outer|외부의|외부의,내부의,안쪽의,중심의|TOEFL
indoor|실내의|실내의,실외의,야외의,밖의|TOEFL
outdoor|실외의|실외의,실내의,안의,내부의|TOEFL
urban|도시의|도시의,시골의,농촌의,전원의|TOEFL
rural|시골의|시골의,도시의,도심의,번화한|TOEFL
domestic|국내의|국내의,국제적인,해외의,외국의|TOEFL
international|국제적인|국제적인,국내의,지역의,내부의|TOEFL
global|세계적인|세계적인,지역적인,국내의,개인적인|TOEFL
local|지역의|지역의,세계적인,국제적인,전국적인|TOEFL
national|국가의|국가의,지역의,국제적인,개인의|TOEFL
regional|지역의|지역의,국가적인,세계적인,전체의|TOEFL
traditional|전통적인|전통적인,현대적인,새로운,혁신적인|TOEFL
modern|현대적인|현대적인,전통적인,고대의,옛날의|TOEFL
ancient|고대의|고대의,현대적인,최신의,새로운|TOEFL
contemporary|현대의|현대의,고대의,과거의,옛날의|TOEFL
historical|역사적인|역사적인,현대적인,미래의,가상의|TOEFL
cultural|문화적인|문화적인,자연적인,물리적인,과학적인|TOEFL
social|사회적인|사회적인,개인적인,사적인,독립적인|TOEFL
political|정치적인|정치적인,경제적인,문화적인,개인적인|TOEFL
economic|경제적인|경제적인,정치적인,문화적인,사회적인|TOEFL
financial|재정적인|재정적인,물리적인,정신적인,도덕적인|TOEFL
commercial|상업적인|상업적인,비영리적인,자선적인,공공의|TOEFL
industrial|산업의|산업의,농업의,상업적인,서비스의|TOEFL
agricultural|농업의|농업의,산업의,상업적인,도시의|TOEFL
environmental|환경의|환경의,경제적인,정치적인,개인적인|TOEFL
natural|자연적인|자연적인,인공적인,가공된,합성된|TOEFL
artificial|인공적인|인공적인,자연적인,실제의,진짜의|TOEFL
chemical|화학적인|화학적인,물리적인,생물학적인,자연적인|TOEFL
physical|물리적인|물리적인,정신적인,감정적인,추상적인|TOEFL
mental|정신적인|정신적인,물리적인,육체적인,실제의|TOEFL
emotional|감정적인|감정적인,이성적인,논리적인,냉정한|TOEFL
rational|이성적인|이성적인,감정적인,충동적인,비논리적인|TOEFL
logical|논리적인|논리적인,비논리적인,감정적인,무작위의|TOEFL
reasonable|합리적인|합리적인,비합리적인,불합리한,터무니없는|TOEFL
practical|실용적인|실용적인,이론적인,비현실적인,추상적인|TOEFL
theoretical|이론적인|이론적인,실용적인,실제적인,현실적인|TOEFL
technical|기술적인|기술적인,예술적인,창의적인,감정적인|TOEFL
scientific|과학적인|과학적인,비과학적인,예술적인,종교적인|TOEFL
medical|의학적인|의학적인,법적인,교육적인,종교적인|TOEFL
legal|법적인|법적인,불법적인,의학적인,도덕적인|TOEFL
illegal|불법적인|불법적인,합법적인,올바른,정당한|TOEFL
moral|도덕적인|도덕적인,부도덕한,비윤리적인,나쁜|TOEFL
ethical|윤리적인|윤리적인,비윤리적인,부도덕한,잘못된|TOEFL
religious|종교적인|종교적인,세속적인,과학적인,무신론적인|TOEFL
spiritual|정신적인|정신적인,물질적인,육체적인,세속적인|TOEFL
material|물질적인|물질적인,정신적인,추상적인,비물질적인|TOEFL
electronic|전자의|전자의,기계적인,수동의,아날로그의|TOEFL
mechanical|기계적인|기계적인,전자의,수동의,자동의|TOEFL
automatic|자동의|자동의,수동의,기계적인,인력의|TOEFL
manual|수동의|수동의,자동의,기계적인,전자의|TOEFL
digital|디지털의|디지털의,아날로그의,수동의,기계적인|TOEFL
virtual|가상의|가상의,실제의,물리적인,현실의|TOEFL
actual|실제의|실제의,가상의,상상의,이론적인|TOEFL
official|공식적인|공식적인,비공식적인,개인적인,사적인|TOEFL
informal|비공식적인|비공식적인,공식적인,격식있는,엄격한|TOEFL
regular|규칙적인|규칙적인,불규칙한,무작위의,임의의|TOEFL
irregular|불규칙한|불규칙한,규칙적인,일정한,정기적인|TOEFL
frequent|빈번한|빈번한,드문,희귀한,가끔의|TOEFL
occasional|가끔의|가끔의,빈번한,항상,지속적인|TOEFL
constant|지속적인|지속적인,변화하는,일시적인,간헐적인|TOEFL
continuous|계속되는|계속되는,중단된,일시적인,간헐적인|TOEFL
temporary|일시적인|일시적인,영구적인,지속적인,오래가는|TOEFL
permanent|영구적인|영구적인,일시적인,짧은,순간적인|TOEFL
immediate|즉각적인|즉각적인,지연된,느린,나중의|TOEFL
instant|즉시의|즉시의,지연된,천천히,나중의|TOEFL
gradual|점진적인|점진적인,급격한,즉각적인,갑작스러운|TOEFL
sudden|갑작스러운|갑작스러운,점진적인,예상된,천천히|TOEFL
rapid|빠른|빠른,느린,점진적인,천천히|TOEFL
swift|빠른|빠른,느린,더딘,천천히|TOEFL
slow|느린|느린,빠른,신속한,급한|TOEFL
quick|빠른|빠른,느린,더딘,천천히|TOEFL
fast|빠른|빠른,느린,천천히,멈춘|TOEFL
smooth|부드러운|부드러운,거친,울퉁불퉁한,딱딱한|TOEFL
rough|거친|거친,부드러운,매끄러운,평평한|TOEFL
gentle|온화한|온화한,거친,사나운,폭력적인|TOEFL
mild|온화한|온화한,격렬한,강한,극심한|TOEFL
severe|극심한|극심한,온화한,약한,부드러운|TOEFL
extreme|극단적인|극단적인,온건한,적당한,보통의|TOEFL
moderate|적당한|적당한,극단적인,과도한,부족한|TOEFL
slight|약간의|약간의,극심한,엄청난,많은|TOEFL
enormous|거대한|거대한,작은,미세한,적은|TOEFL
huge|거대한|거대한,작은,미세한,제한된|TOEFL
vast|광대한|광대한,작은,좁은,제한된|TOEFL
immense|막대한|막대한,작은,적은,제한된|TOEFL
tiny|아주작은|아주작은,거대한,큰,광대한|TOEFL
massive|거대한|거대한,작은,미세한,가벼운|TOEFL
grand|웅장한|웅장한,초라한,작은,평범한|TOEFL
magnificent|장엄한|장엄한,초라한,평범한,작은|TOEFL
splendid|훌륭한|훌륭한,형편없는,끔찍한,나쁜|TOEFL
superb|뛰어난|뛰어난,형편없는,나쁜,열등한|TOEFL
superior|우수한|우수한,열등한,나쁜,못한|TOEFL
inferior|열등한|열등한,우수한,뛰어난,좋은|TOEFL
supreme|최고의|최고의,최저의,열등한,나쁜|TOEFL
prime|주요한|주요한,부차적인,사소한,마지막의|TOEFL
primary|주요한|주요한,부차적인,이차적인,마지막의|TOEFL
secondary|이차적인|이차적인,주요한,첫번째,우선적인|TOEFL
major|주요한|주요한,사소한,부차적인,중요하지않은|TOEFL
minor|사소한|사소한,주요한,중요한,크게|TOEFL
chief|주요한|주요한,부차적인,사소한,마지막의|TOEFL
principal|주요한|주요한,부차적인,사소한,보조적인|TOEFL
essential|필수적인|필수적인,불필요한,선택적인,부차적인|TOEFL
vital|필수적인|필수적인,불필요한,선택적인,무의미한|TOEFL
crucial|결정적인|결정적인,사소한,무의미한,불필요한|TOEFL
critical|중요한|중요한,사소한,무의미한,불필요한|TOEFL
significant|중요한|중요한,사소한,무의미한,무관한|TOEFL
important|중요한|중요한,중요하지않은,사소한,무의미한|TOEFL
necessary|필요한|필요한,불필요한,선택적인,무용한|TOEFL
urgent|긴급한|긴급한,여유로운,천천히,나중의|TOEFL
immediate|즉각적인|즉각적인,지연된,나중의,천천히|TOEFL
direct|직접적인|직접적인,간접적인,우회적인,먼|TOEFL
indirect|간접적인|간접적인,직접적인,즉각적인,가까운|TOEFL
straight|똑바른|똑바른,구부러진,곡선의,휜|TOEFL
narrow|좁은|좁은,넓은,광대한,큰|TOEFL
broad|넓은|넓은,좁은,작은,제한된|TOEFL
wide|넓은|넓은,좁은,작은,제한된|TOEFL
shallow|얕은|얕은,깊은,심오한,복잡한|TOEFL
deep|깊은|깊은,얕은,표면적인,단순한|TOEFL
thick|두꺼운|두꺼운,얇은,가는,좁은|TOEFL
thin|얇은|얇은,두꺼운,넓은,뚱뚱한|TOEFL
dense|밀집한|밀집한,희박한,드문,퍼진|TOEFL
solid|고체의|고체의,액체의,기체의,텅빈|TOEFL
liquid|액체의|액체의,고체의,기체의,딱딱한|TOEFL
hollow|속빈|속빈,꽉찬,단단한,무거운|TOEFL
vacant|비어있는|비어있는,점유된,가득찬,사용중인|TOEFL
bare|벌거벗은|벌거벗은,옷입은,덮인,숨겨진|TOEFL
naked|벌거벗은|벌거벗은,옷입은,덮인,가려진|TOEFL
blank|빈|빈,채워진,쓰여진,그려진|TOEFL
plain|평범한|평범한,화려한,장식된,복잡한|TOEFL
simple|단순한|단순한,복잡한,어려운,정교한|TOEFL
complex|복잡한|복잡한,단순한,쉬운,기본적인|TOEFL
complicated|복잡한|복잡한,단순한,쉬운,명확한|TOEFL
difficult|어려운|어려운,쉬운,간단한,단순한|TOEFL
tough|어려운|어려운,쉬운,간단한,부드러운|TOEFL
harsh|가혹한|가혹한,온화한,부드러운,친절한|TOEFL
strict|엄격한|엄격한,느슨한,관대한,자유로운|TOEFL
tight|빡빡한|빡빡한,느슨한,여유로운,편안한|TOEFL
loose|느슨한|느슨한,빡빡한,단단한,꽉낀|TOEFL
firm|단단한|단단한,부드러운,약한,느슨한|TOEFL
stiff|뻣뻣한|뻣뻣한,유연한,부드러운,느슨한|TOEFL
flexible|유연한|유연한,뻣뻣한,단단한,경직된|TOEFL
rigid|경직된|경직된,유연한,부드러운,적응적인|TOEFL
stable|안정된|안정된,불안정한,흔들리는,변화하는|TOEFL
steady|안정된|안정된,불안정한,흔들리는,변화하는|TOEFL
fixed|고정된|고정된,움직이는,변화하는,유동적인|TOEFL
mobile|움직이는|움직이는,고정된,정지된,부동의|TOEFL
active|활동적인|활동적인,비활동적인,게으른,정지된|TOEFL
passive|수동적인|수동적인,능동적인,활동적인,적극적인|TOEFL
positive|긍정적인|긍정적인,부정적인,비관적인,나쁜|TOEFL
negative|부정적인|부정적인,긍정적인,낙관적인,좋은|TOEFL
neutral|중립적인|중립적인,편향된,편파적인,극단적인|TOEFL
objective|객관적인|객관적인,주관적인,편향된,개인적인|TOEFL
subjective|주관적인|주관적인,객관적인,공정한,중립적인|TOEFL
absolute|절대적인|절대적인,상대적인,조건적인,제한적인|TOEFL
relative|상대적인|상대적인,절대적인,고정된,확정적인|TOEFL
independent|독립적인|독립적인,의존적인,종속적인,관련된|TOEFL
dependent|의존적인|의존적인,독립적인,자립적인,자유로운|TOEFL
mutual|상호의|상호의,일방적인,독립적인,개인적인|TOEFL
individual|개인의|개인의,집단의,공동의,공공의|TOEFL
personal|개인적인|개인적인,공공의,사회적인,집단의|TOEFL
private|사적인|사적인,공공의,공개적인,사회적인|TOEFL
public|공공의|공공의,사적인,개인적인,비밀의|TOEFL
common|공통의|공통의,개인적인,특별한,독특한|TOEFL
general|일반적인|일반적인,특수한,구체적인,개별적인|TOEFL
specific|구체적인|구체적인,일반적인,추상적인,모호한|TOEFL
particular|특정한|특정한,일반적인,보편적인,모든|TOEFL
special|특별한|특별한,일반적인,평범한,보통의|TOEFL
unique|독특한|독특한,일반적인,평범한,흔한|TOEFL
rare|드문|드문,흔한,일반적인,빈번한|TOEFL
common|흔한|흔한,드문,희귀한,특별한|TOEFL
ordinary|평범한|평범한,특별한,독특한,비범한|TOEFL
normal|정상적인|정상적인,비정상적인,이상한,특이한|TOEFL
unusual|특이한|특이한,평범한,일반적인,정상적인|TOEFL
strange|이상한|이상한,정상적인,평범한,일반적인|TOEFL
odd|이상한|이상한,정상적인,평범한,일반적인|TOEFL
weird|이상한|이상한,정상적인,일반적인,평범한|TOEFL
curious|호기심많은|호기심많은,무관심한,냉담한,지루한|TOEFL
eager|열망하는|열망하는,무관심한,꺼리는,싫어하는|TOEFL
willing|기꺼이하는|기꺼이하는,꺼리는,거부하는,싫어하는|TOEFL
reluctant|꺼리는|꺼리는,기꺼이하는,열망하는,원하는|TOEFL
hesitant|망설이는|망설이는,확신하는,단호한,결연한|TOEFL
confident|자신있는|자신있는,자신없는,의심하는,불안한|TOEFL
doubtful|의심스러운|의심스러운,확신하는,확실한,명백한|TOEFL
certain|확실한|확실한,불확실한,의심스러운,모호한|TOEFL
sure|확실한|확실한,불확실한,의심스러운,모호한|TOEFL
definite|명확한|명확한,불명확한,모호한,애매한|TOEFL
vague|모호한|모호한,명확한,분명한,확실한|TOEFL
clear|명확한|명확한,불명확한,모호한,흐린|TOEFL
obvious|명백한|명백한,불명확한,숨겨진,모호한|TOEFL
apparent|명백한|명백한,숨겨진,불명확한,모호한|TOEFL
evident|분명한|분명한,불분명한,숨겨진,모호한|TOEFL
visible|보이는|보이는,보이지않는,숨겨진,가려진|TOEFL
invisible|보이지않는|보이지않는,보이는,명백한,드러난|TOEFL
familiar|친숙한|친숙한,낯선,이상한,새로운|TOEFL
strange|낯선|낯선,친숙한,익숙한,알려진|TOEFL
foreign|외국의|외국의,국내의,토착의,현지의|TOEFL
native|토착의|토착의,외국의,이주한,새로운|TOEFL
domestic|가정의|가정의,야생의,외국의,공공의|TOEFL
wild|야생의|야생의,길들여진,가정의,온순한|TOEFL
tame|길들여진|길들여진,야생의,사나운,거친|TOEFL
fierce|사나운|사나운,온순한,부드러운,친절한|TOEFL
cruel|잔인한|잔인한,친절한,자비로운,부드러운|TOEFL
kind|친절한|친절한,잔인한,불친절한,심술궂은|TOEFL
tender|부드러운|부드러운,거친,딱딱한,잔인한|TOEFL
delicate|연약한|연약한,튼튼한,강한,거친|TOEFL
fragile|깨지기쉬운|깨지기쉬운,튼튼한,강한,내구성있는|TOEFL
attend|참석하다|참석하다,결석하다,떠나다,피하다|SAT
absence|결석|결석,참석,출석,존재|SAT
present|출석한|출석한,결석한,없는,떠난|SAT
absent|결석한|결석한,출석한,있는,참석한|SAT
arrive|도착하다|도착하다,출발하다,떠나다,피하다|SAT
depart|출발하다|출발하다,도착하다,머무르다,정착하다|SAT
enter|들어가다|들어가다,나가다,떠나다,피하다|SAT
exit|나가다|나가다,들어가다,머무르다,들어오다|SAT
include|포함하다|포함하다,제외하다,빼다,거부하다|SAT
exclude|제외하다|제외하다,포함하다,추가하다,받아들이다|SAT
contain|포함하다|포함하다,제외하다,비우다,빼다|SAT
consist|구성되다|구성되다,분리되다,제외되다,나뉘다|SAT
belong|속하다|속하다,떠나다,분리되다,독립하다|SAT
own|소유하다|소유하다,빌리다,잃다,빌려주다|SAT
possess|소유하다|소유하다,빌리다,잃다,거부하다|SAT
lack|부족하다|부족하다,풍부하다,넘치다,충분하다|SAT
require|필요하다|필요하다,불필요하다,거부하다,충분하다|SAT
demand|요구하다|요구하다,제공하다,거부하다,양보하다|SAT
request|요청하다|요청하다,거부하다,명령하다,강요하다|SAT
order|명령하다|명령하다,요청하다,부탁하다,복종하다|SAT
command|명령하다|명령하다,복종하다,요청하다,부탁하다|SAT
obey|복종하다|복종하다,거역하다,거부하다,반항하다|SAT
disobey|거역하다|거역하다,복종하다,따르다,순종하다|SAT
permit|허가하다|허가하다,금지하다,막다,거부하다|SAT
allow|허용하다|허용하다,금지하다,막다,방지하다|SAT
forbid|금지하다|금지하다,허용하다,허가하다,장려하다|SAT
prohibit|금지하다|금지하다,허용하다,장려하다,권장하다|SAT
enable|가능하게하다|가능하게하다,막다,방해하다,금지하다|SAT
prevent|막다|막다,허용하다,허가하다,가능하게하다|SAT
avoid|피하다|피하다,직면하다,맞서다,추구하다|SAT
escape|탈출하다|탈출하다,갇히다,붙잡히다,항복하다|SAT
chase|추격하다|추격하다,도망가다,피하다,숨다|SAT
pursue|추구하다|추구하다,피하다,포기하다,거부하다|SAT
seek|찾다|찾다,피하다,숨기다,포기하다|SAT
search|수색하다|수색하다,숨기다,포기하다,무시하다|SAT
explore|탐험하다|탐험하다,피하다,무시하다,숨다|SAT
discover|발견하다|발견하다,잃다,숨기다,무시하다|SAT
invent|발명하다|발명하다,복사하다,모방하다,파괴하다|SAT
create|창조하다|창조하다,파괴하다,복사하다,모방하다|SAT
produce|생산하다|생산하다,소비하다,파괴하다,낭비하다|SAT
manufacture|제조하다|제조하다,파괴하다,소비하다,수입하다|SAT
construct|건설하다|건설하다,파괴하다,무너뜨리다,철거하다|SAT
build|짓다|짓다,파괴하다,무너뜨리다,철거하다|SAT
destroy|파괴하다|파괴하다,건설하다,보호하다,복구하다|SAT
damage|손상시키다|손상시키다,수리하다,보호하다,개선하다|SAT
repair|수리하다|수리하다,파괴하다,손상시키다,망치다|SAT
fix|고치다|고치다,망가뜨리다,파괴하다,손상시키다|SAT
mend|수선하다|수선하다,찢다,망가뜨리다,버리다|SAT
restore|복원하다|복원하다,파괴하다,손상시키다,망치다|SAT
renew|갱신하다|갱신하다,만료시키다,취소하다,폐기하다|SAT
replace|교체하다|교체하다,유지하다,보존하다,계속하다|SAT
substitute|대체하다|대체하다,유지하다,보존하다,원래대로하다|SAT
exchange|교환하다|교환하다,보관하다,유지하다,거부하다|SAT
trade|거래하다|거래하다,보관하다,숨기다,거부하다|SAT
purchase|구매하다|구매하다,판매하다,거부하다,버리다|SAT
buy|사다|사다,팔다,거부하다,버리다|SAT
sell|팔다|팔다,사다,보관하다,숨기다|SAT
afford|여유가있다|여유가있다,부족하다,불가능하다,거부하다|SAT
cost|비용이들다|비용이들다,무료이다,공짜이다,벌다|SAT
charge|요금을부과하다|요금을부과하다,무료로하다,공짜로주다,할인하다|SAT
pay|지불하다|지불하다,받다,거부하다,빌리다|SAT
spend|쓰다|쓰다,저축하다,벌다,모으다|SAT
save|저축하다|저축하다,쓰다,낭비하다,잃다|SAT
waste|낭비하다|낭비하다,저축하다,절약하다,활용하다|SAT
earn|벌다|벌다,쓰다,잃다,낭비하다|SAT
gain|얻다|얻다,잃다,포기하다,버리다|SAT
obtain|얻다|얻다,잃다,거부하다,포기하다|SAT
acquire|획득하다|획득하다,잃다,포기하다,버리다|SAT
achieve|달성하다|달성하다,실패하다,포기하다,놓치다|SAT
accomplish|성취하다|성취하다,실패하다,포기하다,망치다|SAT
complete|완성하다|완성하다,시작하다,포기하다,중단하다|SAT
finish|끝내다|끝내다,시작하다,계속하다,진행하다|SAT
conclude|결론짓다|결론짓다,시작하다,계속하다,의심하다|SAT
terminate|종료하다|종료하다,시작하다,계속하다,연장하다|SAT
cease|중단하다|중단하다,시작하다,계속하다,확대하다|SAT
quit|그만두다|그만두다,계속하다,시작하다,유지하다|SAT
abandon|포기하다|포기하다,유지하다,계속하다,보호하다|SAT
surrender|항복하다|항복하다,저항하다,싸우다,승리하다|SAT
yield|양보하다|양보하다,저항하다,거부하다,주장하다|SAT
resist|저항하다|저항하다,항복하다,양보하다,따르다|SAT
oppose|반대하다|반대하다,지지하다,찬성하다,동의하다|SAT
support|지지하다|지지하다,반대하다,거부하다,방해하다|SAT
favor|선호하다|선호하다,반대하다,거부하다,싫어하다|SAT
approve|승인하다|승인하다,거부하다,반대하다,불허하다|SAT
disapprove|불허하다|불허하다,승인하다,찬성하다,허가하다|SAT
accept|수락하다|수락하다,거부하다,거절하다,반대하다|SAT
reject|거절하다|거절하다,수락하다,환영하다,받아들이다|SAT
refuse|거부하다|거부하다,수락하다,받아들이다,동의하다|SAT
decline|사양하다|사양하다,수락하다,받아들이다,환영하다|SAT
admit|인정하다|인정하다,부인하다,거부하다,숨기다|SAT
deny|부인하다|부인하다,인정하다,확인하다,동의하다|SAT
confess|고백하다|고백하다,부인하다,숨기다,거부하다|SAT
reveal|드러내다|드러내다,숨기다,감추다,보호하다|SAT
conceal|숨기다|숨기다,드러내다,보여주다,공개하다|SAT
expose|노출시키다|노출시키다,숨기다,보호하다,가리다|SAT
display|전시하다|전시하다,숨기다,보관하다,가리다|SAT
exhibit|전시하다|전시하다,숨기다,보관하다,제거하다|SAT
demonstrate|증명하다|증명하다,숨기다,의심하다,부인하다|SAT
prove|증명하다|증명하다,의심하다,부인하다,반증하다|SAT
confirm|확인하다|확인하다,부인하다,의심하다,취소하다|SAT
verify|확인하다|확인하다,의심하다,부인하다,거부하다|SAT
identify|확인하다|확인하다,숨기다,혼동하다,무시하다|SAT
recognize|인식하다|인식하다,무시하다,모르다,혼동하다|SAT
distinguish|구별하다|구별하다,혼동하다,일치시키다,통합하다|SAT
differ|다르다|다르다,같다,일치하다,유사하다|SAT
resemble|닮다|닮다,다르다,반대되다,대조되다|SAT
compare|비교하다|비교하다,대조하다,무시하다,혼동하다|SAT
contrast|대조하다|대조하다,비교하다,일치시키다,유사하다|SAT
match|일치하다|일치하다,다르다,대조되다,반대되다|SAT
correspond|일치하다|일치하다,다르다,모순되다,반대되다|SAT
suit|어울리다|어울리다,어울리지않다,충돌하다,반대되다|SAT
fit|맞다|맞다,맞지않다,크다,작다|SAT
adapt|적응하다|적응하다,거부하다,저항하다,변하지않다|SAT
adjust|조정하다|조정하다,고정하다,유지하다,변경하지않다|SAT
modify|수정하다|수정하다,유지하다,보존하다,고정하다|SAT
alter|변경하다|변경하다,유지하다,보존하다,고정하다|SAT
change|바꾸다|바꾸다,유지하다,보존하다,계속하다|SAT
transform|변형하다|변형하다,유지하다,보존하다,원래대로하다|SAT
convert|전환하다|전환하다,유지하다,보존하다,원래대로하다|SAT
shift|이동하다|이동하다,머무르다,고정하다,유지하다|SAT
transfer|옮기다|옮기다,유지하다,고정하다,보관하다|SAT
transport|운송하다|운송하다,보관하다,고정하다,유지하다|SAT
carry|나르다|나르다,놓다,버리다,고정하다|SAT
deliver|배달하다|배달하다,보관하다,유지하다,보류하다|SAT
distribute|분배하다|분배하다,모으다,집중하다,보관하다|SAT
spread|퍼뜨리다|퍼뜨리다,모으다,집중하다,제한하다|SAT
scatter|흩어지다|흩어지다,모으다,집중하다,모이다|SAT
gather|모으다|모으다,흩어지다,분산하다,버리다|SAT
collect|수집하다|수집하다,흩어지다,버리다,분산하다|SAT
assemble|모으다|모으다,분해하다,흩어지다,해산하다|SAT
separate|분리하다|분리하다,결합하다,합치다,통합하다|SAT
divide|나누다|나누다,합치다,결합하다,통합하다|SAT
split|나누다|나누다,합치다,결합하다,통합하다|SAT
unite|연합하다|연합하다,분리하다,나누다,독립하다|SAT
combine|결합하다|결합하다,분리하다,나누다,해체하다|SAT
join|연결하다|연결하다,분리하다,끊다,떼다|SAT
connect|연결하다|연결하다,분리하다,끊다,차단하다|SAT
attach|붙이다|붙이다,떼다,분리하다,제거하다|SAT
detach|떼다|떼다,붙이다,연결하다,결합하다|SAT
link|연결하다|연결하다,분리하다,끊다,독립하다|SAT
relate|관련시키다|관련시키다,분리하다,무관하다,독립하다|SAT
associate|연관시키다|연관시키다,분리하다,무관하다,독립하다|SAT
involve|포함하다|포함하다,제외하다,분리하다,독립하다|SAT
participate|참여하다|참여하다,거부하다,관찰하다,피하다|SAT
engage|참여하다|참여하다,피하다,거부하다,무시하다|SAT
contribute|기여하다|기여하다,방해하다,해치다,거부하다|SAT
donate|기부하다|기부하다,받다,빼앗다,요구하다|SAT
provide|제공하다|제공하다,빼앗다,거부하다,요구하다|SAT
supply|공급하다|공급하다,빼앗다,고갈시키다,제한하다|SAT
offer|제공하다|제공하다,거부하다,빼앗다,요구하다|SAT
present|제시하다|제시하다,숨기다,보류하다,거부하다|SAT
submit|제출하다|제출하다,보류하다,거부하다,숨기다|SAT
propose|제안하다|제안하다,거부하다,반대하다,철회하다|SAT
suggest|제안하다|제안하다,거부하다,반대하다,명령하다|SAT
recommend|추천하다|추천하다,반대하다,거부하다,경고하다|SAT
urge|촉구하다|촉구하다,말리다,반대하다,금지하다|SAT
persuade|설득하다|설득하다,말리다,반대하다,의심하게하다|SAT
convince|설득하다|설득하다,의심하게하다,반대하다,거부하다|SAT
influence|영향을주다|영향을주다,무시하다,피하다,독립하다|SAT
affect|영향을끼치다|영향을끼치다,무시하다,피하다,독립하다|SAT
impact|영향을미치다|영향을미치다,무시하다,피하다,독립하다|SAT
impress|감동시키다|감동시키다,지루하게하다,실망시키다,무감동시키다|SAT
attract|끌다|끌다,밀다,거부하다,피하다|SAT
appeal|호소하다|호소하다,거부하다,무시하다,반발하다|SAT
tempt|유혹하다|유혹하다,말리다,거부하다,경고하다|SAT
encourage|격려하다|격려하다,낙담시키다,말리다,방해하다|SAT
discourage|낙담시키다|낙담시키다,격려하다,고무시키다,지원하다|SAT
inspire|영감을주다|영감을주다,낙담시키다,지루하게하다,무감동시키다|SAT
motivate|동기부여하다|동기부여하다,낙담시키다,방해하다,막다|SAT
stimulate|자극하다|자극하다,진정시키다,억제하다,방해하다|SAT
arouse|불러일으키다|불러일으키다,진정시키다,억제하다,숨기다|SAT
excite|흥분시키다|흥분시키다,진정시키다,지루하게하다,우울하게하다|SAT
thrill|흥분시키다|흥분시키다,지루하게하다,진정시키다,우울하게하다|SAT
amuse|즐겁게하다|즐겁게하다,지루하게하다,슬프게하다,화나게하다|SAT
entertain|즐겁게하다|즐겁게하다,지루하게하다,슬프게하다,우울하게하다|SAT
delight|기쁘게하다|기쁘게하다,슬프게하다,화나게하다,실망시키다|SAT
please|기쁘게하다|기쁘게하다,화나게하다,슬프게하다,실망시키다|SAT
satisfy|만족시키다|만족시키다,실망시키다,화나게하다,좌절시키다|SAT
content|만족시키다|만족시키다,실망시키다,불만족시키다,화나게하다|SAT
comfort|위로하다|위로하다,괴롭히다,슬프게하다,화나게하다|SAT
console|위로하다|위로하다,괴롭히다,슬프게하다,무시하다|SAT
soothe|달래다|달래다,화나게하다,자극하다,괴롭히다|SAT
calm|진정시키다|진정시키다,흥분시키다,자극하다,화나게하다|SAT
relax|편안하게하다|편안하게하다,긴장시키다,스트레스주다,자극하다|SAT
relieve|완화하다|완화하다,악화시키다,증가시키다,괴롭히다|SAT
ease|완화하다|완화하다,악화시키다,증가시키다,강화하다|SAT
reduce|줄이다|줄이다,증가시키다,확대하다,강화하다|SAT
decrease|감소시키다|감소시키다,증가시키다,확대하다,늘리다|SAT
lessen|줄이다|줄이다,증가시키다,확대하다,강화하다|SAT
lower|낮추다|낮추다,높이다,올리다,증가시키다|SAT
diminish|줄어들다|줄어들다,증가하다,확대되다,강화되다|SAT
shrink|줄어들다|줄어들다,확대되다,늘어나다,팽창하다|SAT
contract|수축하다|수축하다,확장하다,팽창하다,늘어나다|SAT
expand|확장하다|확장하다,축소하다,줄이다,제한하다|SAT
extend|연장하다|연장하다,단축하다,줄이다,제한하다|SAT
enlarge|확대하다|확대하다,축소하다,줄이다,제한하다|SAT
increase|증가시키다|증가시키다,감소시키다,줄이다,제한하다|SAT
raise|올리다|올리다,낮추다,떨어뜨리다,줄이다|SAT
lift|들어올리다|들어올리다,내리다,떨어뜨리다,낮추다|SAT
elevate|높이다|높이다,낮추다,떨어뜨리다,내리다|SAT
promote|승진시키다|승진시키다,강등시키다,해고하다,좌천시키다|SAT
advance|전진시키다|전진시키다,후퇴시키다,지연시키다,막다|SAT
progress|진보하다|진보하다,후퇴하다,퇴보하다,정체하다|SAT
develop|발전시키다|발전시키다,악화시키다,퇴보시키다,정체시키다|SAT
improve|개선하다|개선하다,악화시키다,망치다,파괴하다|SAT
enhance|향상시키다|향상시키다,악화시키다,저하시키다,망치다|SAT
strengthen|강화하다|강화하다,약화시키다,파괴하다,무너뜨리다|SAT
weaken|약화시키다|약화시키다,강화하다,강화하다,튼튼하게하다|SAT
undermine|약화시키다|약화시키다,강화하다,지지하다,돕다|SAT
threaten|위협하다|위협하다,보호하다,안전하게하다,격려하다|SAT
endanger|위험하게하다|위험하게하다,보호하다,안전하게하다,구하다|SAT
risk|위험을감수하다|위험을감수하다,안전하게하다,보호하다,피하다|SAT
dare|감히하다|감히하다,두려워하다,피하다,거부하다|SAT
venture|모험하다|모험하다,피하다,두려워하다,거부하다|SAT
attempt|시도하다|시도하다,포기하다,거부하다,피하다|SAT
endeavor|노력하다|노력하다,포기하다,게으름피우다,무시하다|SAT
strive|노력하다|노력하다,포기하다,게으름피우다,나태하다|SAT
struggle|고군분투하다|고군분투하다,쉽게하다,포기하다,게으름피우다|SAT
suffer|고통받다|고통받다,즐기다,행복하다,편안하다|SAT
endure|견디다|견디다,포기하다,항복하다,피하다|SAT
bear|견디다|견디다,포기하다,거부하다,피하다|SAT
tolerate|참다|참다,거부하다,반대하다,비난하다|SAT
stand|견디다|견디다,포기하다,항복하다,피하다|SAT
survive|생존하다|생존하다,죽다,사라지다,패배하다|SAT
exist|존재하다|존재하다,사라지다,죽다,소멸하다|SAT
remain|남다|남다,떠나다,사라지다,변하다|SAT
stay|머무르다|머무르다,떠나다,이동하다,변하다|SAT
persist|지속하다|지속하다,중단하다,포기하다,변하다|SAT
continue|계속하다|계속하다,중단하다,멈추다,끝내다|SAT
maintain|유지하다|유지하다,변경하다,중단하다,파괴하다|SAT
preserve|보존하다|보존하다,파괴하다,변경하다,버리다|SAT
conserve|보존하다|보존하다,낭비하다,파괴하다,소비하다|SAT
retain|유지하다|유지하다,잃다,포기하다,버리다|SAT
keep|유지하다|유지하다,잃다,버리다,포기하다|SAT