happy|행복한|행복한,슬픈,화난,피곤한|TOEFL
sad|슬픈|슬픈,기쁜,즐거운,신나는|TOEFL
big|큰|큰,작은,중간의,없는|TOEFL
small|작은|작은,큰,넓은,높은|TOEFL
good|좋은|좋은,나쁜,평범한,이상한|TOEFL
bad|나쁜|나쁜,좋은,훌륭한,멋진|TOEFL
hot|뜨거운|뜨거운,차가운,시원한,따뜻한|TOEFL
cold|차가운|차가운,뜨거운,따뜻한,미지근한|TOEFL
new|새로운|새로운,오래된,낡은,중고의|TOEFL
old|오래된|오래된,새로운,최신의,현대의|TOEFL
young|젊은|젊은,늙은,중년의,노인의|TOEFL
easy|쉬운|쉬운,어려운,복잡한,힘든|TOEFL
hard|어려운|어려운,쉬운,간단한,단순한|TOEFL
fast|빠른|빠른,느린,천천히,멈춘|TOEFL
slow|느린|느린,빠른,급한,즉시|TOEFL
tall|키큰|키큰,작은,낮은,짧은|TOEFL
short|짧은|짧은,긴,높은,넓은|TOEFL
long|긴|긴,짧은,작은,좁은|TOEFL
high|높은|높은,낮은,짧은,평평한|TOEFL
low|낮은|낮은,높은,긴,큰|TOEFL
strong|강한|강한,약한,부드러운,연약한|TOEFL
weak|약한|약한,강한,튼튼한,견고한|TOEFL
clean|깨끗한|깨끗한,더러운,지저분한,오염된|TOEFL
dirty|더러운|더러운,깨끗한,맑은,순수한|TOEFL
full|가득한|가득한,빈,부족한,텅빈|TOEFL
empty|빈|빈,가득한,넘치는,채워진|TOEFL
heavy|무거운|무거운,가벼운,작은,빈|TOEFL
light|가벼운|가벼운,무거운,단단한,큰|TOEFL
dark|어두운|어두운,밝은,환한,빛나는|TOEFL
bright|밝은|밝은,어두운,흐린,캄캄한|TOEFL
warm|따뜻한|따뜻한,차가운,시원한,얼음같은|TOEFL
cool|시원한|시원한,뜨거운,따뜻한,더운|TOEFL
wet|젖은|젖은,마른,건조한,바싹|TOEFL
dry|마른|마른,젖은,축축한,물기있는|TOEFL
rich|부유한|부유한,가난한,빈곤한,궁핍한|TOEFL
poor|가난한|가난한,부유한,풍족한,부자인|TOEFL
cheap|싼|싼,비싼,고가의,값비싼|TOEFL
expensive|비싼|비싼,싼,저렴한,무료의|TOEFL
near|가까운|가까운,먼,멀리,저편의|TOEFL
far|먼|먼,가까운,인접한,옆의|TOEFL
wide|넓은|넓은,좁은,작은,빽빽한|TOEFL
narrow|좁은|좁은,넓은,큰,광대한|TOEFL
thick|두꺼운|두꺼운,얇은,가는,좁은|TOEFL
thin|얇은|얇은,두꺼운,넓은,뚱뚱한|TOEFL
soft|부드러운|부드러운,딱딱한,거친,단단한|TOEFL
loud|시끄러운|시끄러운,조용한,고요한,무음의|TOEFL
quiet|조용한|조용한,시끄러운,떠들썩한,요란한|TOEFL
beautiful|아름다운|아름다운,못생긴,추한,평범한|TOEFL
ugly|못생긴|못생긴,아름다운,예쁜,멋진|TOEFL
smart|똑똑한|똑똑한,어리석은,바보같은,멍청한|TOEFL
stupid|어리석은|어리석은,똑똑한,영리한,현명한|TOEFL
kind|친절한|친절한,불친절한,심술궂은,나쁜|TOEFL
mean|심술궂은|심술궂은,친절한,상냥한,다정한|TOEFL
brave|용감한|용감한,겁많은,비겁한,두려운|TOEFL
afraid|두려운|두려운,용감한,대담한,무서운|TOEFL
angry|화난|화난,기쁜,행복한,즐거운|TOEFL
glad|기쁜|기쁜,슬픈,우울한,화난|TOEFL
hungry|배고픈|배고픈,배부른,포만한,가득찬|TOEFL
thirsty|목마른|목마른,배부른,포만한,충분한|TOEFL
tired|피곤한|피곤한,활기찬,신나는,쌩쌩한|TOEFL
busy|바쁜|바쁜,한가한,여유로운,쉬는|TOEFL
free|자유로운|자유로운,갇힌,구속된,제한된|TOEFL
safe|안전한|안전한,위험한,불안한,무서운|TOEFL
dangerous|위험한|위험한,안전한,평화로운,조용한|TOEFL
careful|조심스러운|조심스러운,부주의한,함부로,무모한|TOEFL
quick|빠른|빠른,느린,천천히,더딘|TOEFL
early|이른|이른,늦은,지각한,뒤늦은|TOEFL
late|늦은|늦은,이른,일찍,빠른|TOEFL
ready|준비된|준비된,준비안된,부족한,없는|TOEFL
wrong|틀린|틀린,맞는,정확한,옳은|TOEFL
right|옳은|옳은,틀린,잘못된,부정확한|TOEFL
true|진실한|진실한,거짓된,가짜의,속임수|TOEFL
false|거짓된|거짓된,진실한,사실인,정직한|TOEFL
sure|확실한|확실한,불확실한,의심스러운,애매한|TOEFL
clear|명확한|명확한,불명확한,흐린,모호한|TOEFL
simple|간단한|간단한,복잡한,어려운,힘든|TOEFL
difficult|어려운|어려운,쉬운,간단한,단순한|TOEFL
important|중요한|중요한,중요하지않은,사소한,무의미한|TOEFL
useful|유용한|유용한,쓸모없는,무익한,불필요한|TOEFL
special|특별한|특별한,평범한,일반적인,보통의|TOEFL
common|일반적인|일반적인,특별한,독특한,희귀한|TOEFL
strange|이상한|이상한,정상적인,평범한,일반적인|TOEFL
different|다른|다른,같은,동일한,유사한|TOEFL
same|같은|같은,다른,상이한,별개의|TOEFL
similar|유사한|유사한,다른,반대의,상이한|TOEFL
popular|인기있는|인기있는,인기없는,싫어하는,평범한|TOEFL
famous|유명한|유명한,무명의,알려지지않은,평범한|TOEFL
favorite|가장좋아하는|가장좋아하는,싫어하는,혐오하는,평범한|TOEFL
perfect|완벽한|완벽한,불완전한,결함있는,나쁜|TOEFL
terrible|끔찍한|끔찍한,훌륭한,좋은,멋진|TOEFL
wonderful|멋진|멋진,끔찍한,나쁜,형편없는|TOEFL
excellent|훌륭한|훌륭한,나쁜,형편없는,끔찍한|TOEFL
great|위대한|위대한,하찮은,작은,평범한|TOEFL
fine|좋은|좋은,나쁜,형편없는,끔찍한|TOEFL
nice|좋은|좋은,나쁜,불쾌한,끔찍한|TOEFL
pleasant|즐거운|즐거운,불쾌한,싫은,끔찍한|TOEFL
awful|끔찍한|끔찍한,훌륭한,멋진,좋은|TOEFL
lovely|사랑스러운|사랑스러운,끔찍한,혐오스러운,싫은|TOEFL
pretty|예쁜|예쁜,못생긴,추한,끔찍한|TOEFL
cute|귀여운|귀여운,무서운,끔찍한,싫은|TOEFL
handsome|잘생긴|잘생긴,못생긴,추한,평범한|TOEFL
gentle|온화한|온화한,거친,사나운,폭력적인|TOEFL
polite|예의바른|예의바른,무례한,버릇없는,거친|TOEFL
rude|무례한|무례한,예의바른,공손한,친절한|TOEFL
honest|정직한|정직한,거짓말하는,속이는,부정직한|TOEFL
lazy|게으른|게으른,부지런한,열심히,성실한|TOEFL
active|활동적인|활동적인,게으른,나태한,조용한|TOEFL
shy|수줍은|수줍은,대담한,용감한,활발한|TOEFL
proud|자랑스러운|자랑스러운,부끄러운,창피한,겸손한|TOEFL
lonely|외로운|외로운,함께있는,즐거운,행복한|TOEFL
surprised|놀란|놀란,예상한,무관심한,지루한|TOEFL
excited|신나는|신나는,지루한,심심한,조용한|TOEFL
worried|걱정하는|걱정하는,안심하는,평온한,여유로운|TOEFL
nervous|긴장한|긴장한,편안한,여유로운,평온한|TOEFL
bored|지루한|지루한,신나는,즐거운,재미있는|TOEFL
interested|관심있는|관심있는,무관심한,지루한,싫어하는|TOEFL
comfortable|편안한|편안한,불편한,답답한,괴로운|TOEFL
sick|아픈|아픈,건강한,튼튼한,쌩쌩한|TOEFL
healthy|건강한|건강한,아픈,병든,약한|TOEFL
painful|아픈|아픈,편안한,좋은,쾌적한|TOEFL
fresh|신선한|신선한,상한,썩은,오래된|TOEFL
delicious|맛있는|맛있는,맛없는,역겨운,끔찍한|TOEFL
sweet|달콤한|달콤한,쓴,신,짠|TOEFL
sour|신|신,단,짠,쓴|TOEFL
bitter|쓴|쓴,단,신,맛있는|TOEFL
salty|짠|짠,단,신,쓴|TOEFL
spicy|매운|매운,순한,단,신|TOEFL
hungry|배고픈|배고픈,배부른,포만한,충분한|TOEFL
crowded|붐비는|붐비는,한산한,비어있는,조용한|TOEFL
noisy|시끄러운|시끄러운,조용한,고요한,평화로운|TOEFL
silent|조용한|조용한,시끄러운,떠들썩한,소란스러운|TOEFL
cheerful|명랑한|명랑한,우울한,슬픈,침울한|TOEFL
serious|진지한|진지한,장난스러운,가벼운,우스운|TOEFL
funny|웃긴|웃긴,슬픈,진지한,심각한|TOEFL
boring|지루한|지루한,재미있는,흥미로운,신나는|TOEFL
interesting|흥미로운|흥미로운,지루한,심심한,재미없는|TOEFL
modern|현대적인|현대적인,고대의,낡은,오래된|TOEFL
ancient|고대의|고대의,현대적인,새로운,최신의|TOEFL
wild|야생의|야생의,길들여진,가정의,온순한|TOEFL
tame|길들여진|길들여진,야생의,사나운,거친|TOEFL
sharp|날카로운|날카로운,무딘,둥근,부드러운|TOEFL
flat|평평한|평평한,울퉁불퉁한,고르지않은,경사진|TOEFL
round|둥근|둥근,네모난,날카로운,평평한|TOEFL
square|네모난|네모난,둥근,삼각형의,평평한|TOEFL
straight|똑바른|똑바른,구부러진,휜,곡선의|TOEFL
smooth|매끄러운|매끄러운,거친,울퉁불퉁한,딱딱한|TOEFL
rough|거친|거친,매끄러운,부드러운,평평한|TOEFL
tight|꽉끼는|꽉끼는,헐렁한,넉넉한,큰|TOEFL
loose|느슨한|느슨한,꽉낀,타이트한,단단한|TOEFL
wooden|나무로된|나무로된,금속의,플라스틱의,유리의|TOEFL
plastic|플라스틱의|플라스틱의,나무의,금속의,유리의|TOEFL
metal|금속의|금속의,나무의,플라스틱의,종이의|TOEFL
silly|바보같은|바보같은,똑똑한,현명한,영리한|TOEFL
wise|현명한|현명한,어리석은,바보같은,멍청한|TOEFL
clever|영리한|영리한,어리석은,둔한,바보같은|TOEFL
foolish|어리석은|어리석은,현명한,똑똑한,영리한|TOEFL
blind|눈먼|눈먼,볼수있는,밝은,명확한|TOEFL
deaf|귀먼|귀먼,들을수있는,예민한,밝은|TOEFL
dumb|말못하는|말못하는,말하는,시끄러운,떠드는|TOEFL
lame|절름발이의|절름발이의,건강한,튼튼한,쌩쌩한|TOEFL
mad|미친|미친,정상적인,평온한,침착한|TOEFL
crazy|미친|미친,정상적인,이성적인,침착한|TOEFL
possible|가능한|가능한,불가능한,안되는,막힌|TOEFL
impossible|불가능한|불가능한,가능한,쉬운,되는|TOEFL
necessary|필요한|필요한,불필요한,쓸모없는,무용한|TOEFL
regular|규칙적인|규칙적인,불규칙한,무작위의,제멋대로|TOEFL
irregular|불규칙한|불규칙한,규칙적인,일정한,정돈된|TOEFL
public|공공의|공공의,사적인,개인적인,비밀의|TOEFL
private|사적인|사적인,공공의,공개적인,모두의|TOEFL
correct|옳은|옳은,틀린,잘못된,부정확한|TOEFL
incorrect|틀린|틀린,맞는,옳은,정확한|TOEFL
proper|적절한|적절한,부적절한,틀린,잘못된|TOEFL
main|주요한|주요한,부차적인,사소한,마지막의|TOEFL
personal|개인적인|개인적인,공공의,공개적인,사회적인|TOEFL
social|사회적인|사회적인,개인적인,사적인,혼자의|TOEFL
national|국가의|국가의,지역의,개인의,외국의|TOEFL
local|지역의|지역의,국가의,세계적인,국제적인|TOEFL
foreign|외국의|외국의,국내의,지역의,토착의|TOEFL
native|원래의|원래의,외국의,새로운,이주한|TOEFL
natural|자연의|자연의,인공의,가짜의,조작된|TOEFL
artificial|인공의|인공의,자연의,진짜의,실제의|TOEFL
real|진짜의|진짜의,가짜의,거짓된,조작된|TOEFL
actual|실제의|실제의,가상의,상상의,거짓의|TOEFL
formal|형식적인|형식적인,비형식적인,편한,자유로운|TOEFL
informal|비형식적인|비형식적인,형식적인,공식적인,격식있는|TOEFL
positive|긍정적인|긍정적인,부정적인,나쁜,비관적인|TOEFL
negative|부정적인|부정적인,긍정적인,좋은,낙관적인|TOEFL
normal|정상적인|정상적인,비정상적인,이상한,특이한|TOEFL
usual|평소의|평소의,특별한,이례적인,드문|TOEFL
unusual|특이한|특이한,평범한,일반적인,보통의|TOEFL
ordinary|평범한|평범한,특별한,비범한,독특한|TOEFL
extra|추가의|추가의,기본의,필수의,표준의|TOEFL
single|단일의|단일의,복수의,여러,많은|TOEFL
double|두배의|두배의,절반의,단일의,하나의|TOEFL
separate|분리된|분리된,결합된,함께,통합된|TOEFL
general|일반적인|일반적인,특수한,구체적인,개별의|TOEFL
particular|특정한|특정한,일반적인,모든,전체의|TOEFL
whole|전체의|전체의,부분의,일부의,조각의|TOEFL
complete|완전한|완전한,불완전한,부족한,미완성의|TOEFL
total|전체의|전체의,부분적인,일부의,불완전한|TOEFL
entire|전체의|전체의,부분적인,일부의,불완전한|TOEFL
basic|기본적인|기본적인,고급의,복잡한,전문적인|TOEFL
simple|단순한|단순한,복잡한,어려운,고급의|TOEFL
complex|복잡한|복잡한,단순한,쉬운,기본적인|TOEFL
direct|직접적인|직접적인,간접적인,우회적인,돌아가는|TOEFL
indirect|간접적인|간접적인,직접적인,똑바른,즉각적인|TOEFL
immediate|즉각적인|즉각적인,지연된,나중의,미래의|TOEFL
final|최종의|최종의,초기의,첫번째,시작의|TOEFL
initial|초기의|초기의,최종의,마지막,끝의|TOEFL
prior|이전의|이전의,이후의,다음의,미래의|TOEFL
former|이전의|이전의,현재의,다음의,미래의|TOEFL
latter|후자의|후자의,전자의,처음의,앞의|TOEFL
previous|이전의|이전의,다음의,이후의,미래의|TOEFL
next|다음의|다음의,이전의,마지막,첫번째|TOEFL
present|현재의|현재의,과거의,미래의,옛날의|TOEFL
past|과거의|과거의,현재의,미래의,지금의|TOEFL
future|미래의|미래의,과거의,현재의,지금의|TOEFL
recent|최근의|최근의,오래된,과거의,옛날의|TOEFL
current|현재의|현재의,과거의,이전의,옛날의|TOEFL
sudden|갑작스러운|갑작스러운,점진적인,천천히,예상된|TOEFL
gradual|점진적인|점진적인,갑작스러운,급격한,즉시|TOEFL
rapid|빠른|빠른,느린,점진적인,천천히|TOEFL
constant|지속적인|지속적인,변화하는,일시적인,불규칙한|TOEFL
temporary|일시적인|일시적인,영구적인,지속적인,오래가는|TOEFL
permanent|영구적인|영구적인,일시적인,짧은,순간적인|TOEFL
eternal|영원한|영원한,일시적인,짧은,끝나는|TOEFL
brief|짧은|짧은,긴,오래된,영구적인|TOEFL
frequent|빈번한|빈번한,드문,희귀한,거의없는|TOEFL
rare|드문|드문,흔한,빈번한,일반적인|TOEFL
scarce|부족한|부족한,풍부한,많은,넘치는|TOEFL
plenty|풍부한|풍부한,부족한,희소한,적은|TOEFL
various|다양한|다양한,단일한,하나의,같은|TOEFL
numerous|많은|많은,적은,하나의,거의없는|TOEFL
several|몇몇의|몇몇의,모든,전체의,하나의|TOEFL
many|많은|많은,적은,하나의,없는|TOEFL
few|적은|적은,많은,풍부한,넘치는|TOEFL
much|많은|많은,적은,조금,없는|TOEFL
little|적은|적은,많은,풍부한,넘치는|TOEFL
enough|충분한|충분한,부족한,불충분한,모자란|TOEFL
sufficient|충분한|충분한,부족한,불충분한,모자란|TOEFL
insufficient|불충분한|불충분한,충분한,풍부한,넘치는|TOEFL
abundant|풍부한|풍부한,부족한,희소한,적은|TOEFL
lacking|부족한|부족한,풍부한,충분한,넘치는|TOEFL
mere|단순한|단순한,복잡한,완전한,충분한|TOEFL
pure|순수한|순수한,불순한,더러운,섞인|TOEFL
mixed|섞인|섞인,순수한,단일한,깨끗한|TOEFL
combined|결합된|결합된,분리된,나뉜,독립된|TOEFL
united|연합된|연합된,분리된,나뉜,독립된|TOEFL
joint|공동의|공동의,개인의,분리된,독립된|TOEFL
mutual|상호의|상호의,일방적인,개인의,독립된|TOEFL
equal|평등한|평등한,불평등한,다른,차별된|TOEFL
fair|공정한|공정한,불공정한,편향된,차별적인|TOEFL
unfair|불공정한|불공정한,공정한,평등한,올바른|TOEFL
just|공정한|공정한,불공정한,편향된,틀린|TOEFL
unjust|불공정한|불공정한,공정한,올바른,평등한|TOEFL
learn|배우다|배우다,가르치다,모르다,잊다|SAT
teach|가르치다|가르치다,배우다,모르다,숨기다|SAT
study|공부하다|공부하다,놀다,쉬다,자다|SAT
read|읽다|읽다,쓰다,말하다,듣다|SAT
write|쓰다|쓰다,읽다,말하다,지우다|SAT
speak|말하다|말하다,듣다,읽다,쓰다|SAT
listen|듣다|듣다,말하다,보다,만지다|SAT
look|보다|보다,듣다,만지다,냄새맡다|SAT
see|보다|보다,듣다,만지다,맛보다|SAT
watch|지켜보다|지켜보다,무시하다,듣다,만지다|SAT
hear|듣다|듣다,보다,냄새맡다,만지다|SAT
smell|냄새맡다|냄새맡다,보다,듣다,만지다|SAT
taste|맛보다|맛보다,보다,듣다,냄새맡다|SAT
touch|만지다|만지다,보다,듣다,피하다|SAT
feel|느끼다|느끼다,무시하다,보다,듣다|SAT
think|생각하다|생각하다,행동하다,잊다,무시하다|SAT
know|알다|알다,모르다,잊다,의심하다|SAT
understand|이해하다|이해하다,오해하다,모르다,혼란스러워하다|SAT
remember|기억하다|기억하다,잊다,모르다,무시하다|SAT
forget|잊다|잊다,기억하다,알다,배우다|SAT
believe|믿다|믿다,의심하다,부정하다,거부하다|SAT
hope|희망하다|희망하다,포기하다,의심하다,두려워하다|SAT
wish|바라다|바라다,포기하다,거부하다,싫어하다|SAT
want|원하다|원하다,거부하다,싫어하다,피하다|SAT
need|필요하다|필요하다,거부하다,충분하다,싫어하다|SAT
like|좋아하다|좋아하다,싫어하다,혐오하다,거부하다|SAT
love|사랑하다|사랑하다,싫어하다,혐오하다,무시하다|SAT
hate|싫어하다|싫어하다,좋아하다,사랑하다,선호하다|SAT
prefer|선호하다|선호하다,싫어하다,거부하다,혐오하다|SAT
enjoy|즐기다|즐기다,싫어하다,고통스러워하다,피하다|SAT
try|시도하다|시도하다,포기하다,거부하다,피하다|SAT
help|돕다|돕다,방해하다,무시하다,해치다|SAT
make|만들다|만들다,파괴하다,무시하다,잃다|SAT
do|하다|하다,안하다,포기하다,무시하다|SAT
take|가져가다|가져가다,주다,놓다,버리다|SAT
give|주다|주다,받다,빼앗다,거부하다|SAT
get|얻다|얻다,잃다,주다,버리다|SAT
bring|가져오다|가져오다,가져가다,놓다,버리다|SAT
carry|나르다|나르다,놓다,버리다,던지다|SAT
put|놓다|놓다,가져가다,들다,던지다|SAT
keep|유지하다|유지하다,버리다,주다,잃다|SAT
hold|잡다|잡다,놓다,던지다,떨어뜨리다|SAT
catch|잡다|잡다,놓치다,던지다,떨어뜨리다|SAT
throw|던지다|던지다,잡다,놓다,보관하다|SAT
drop|떨어뜨리다|떨어뜨리다,잡다,들다,보관하다|SAT
break|깨다|깨다,고치다,만들다,보호하다|SAT
fix|고치다|고치다,깨다,파괴하다,무시하다|SAT
build|짓다|짓다,파괴하다,무너뜨리다,무시하다|SAT
create|창조하다|창조하다,파괴하다,복사하다,잃다|SAT
destroy|파괴하다|파괴하다,만들다,보호하다,고치다|SAT
open|열다|열다,닫다,잠그다,막다|SAT
close|닫다|닫다,열다,여는,통과하다|SAT
start|시작하다|시작하다,끝내다,멈추다,완료하다|SAT
begin|시작하다|시작하다,끝내다,멈추다,마치다|SAT
finish|끝내다|끝내다,시작하다,계속하다,진행하다|SAT
end|끝내다|끝내다,시작하다,계속하다,진행하다|SAT
stop|멈추다|멈추다,시작하다,계속하다,진행하다|SAT
continue|계속하다|계속하다,멈추다,끝내다,중단하다|SAT
go|가다|가다,오다,머무르다,멈추다|SAT
come|오다|오다,가다,떠나다,피하다|SAT
move|움직이다|움직이다,멈추다,정지하다,고정하다|SAT
run|달리다|달리다,걷다,멈추다,앉다|SAT
walk|걷다|걷다,달리다,멈추다,앉다|SAT
jump|뛰다|뛰다,걷다,앉다,눕다|SAT
sit|앉다|앉다,서다,눕다,걷다|SAT
stand|서다|서다,앉다,눕다,걷다|SAT
lie|눕다|눕다,서다,앉다,걷다|SAT
sleep|자다|자다,깨다,일어나다,활동하다|SAT
wake|깨다|깨다,자다,눕다,쉬다|SAT
rise|일어나다|일어나다,눕다,앉다,내려가다|SAT
fall|떨어지다|떨어지다,오르다,날다,서다|SAT
fly|날다|날다,걷다,기다,수영하다|SAT
swim|수영하다|수영하다,걷다,달리다,날다|SAT
climb|오르다|오르다,내려가다,떨어지다,걷다|SAT
turn|돌다|돌다,직진하다,멈추다,고정하다|SAT
push|밀다|밀다,당기다,놓다,멈추다|SAT
pull|당기다|당기다,밀다,놓다,던지다|SAT
lift|들다|들다,놓다,떨어뜨리다,내리다|SAT
raise|올리다|올리다,내리다,떨어뜨리다,놓다|SAT
lower|낮추다|낮추다,올리다,높이다,들다|SAT
send|보내다|보내다,받다,유지하다,보관하다|SAT
receive|받다|받다,보내다,주다,거부하다|SAT
call|부르다|부르다,무시하다,피하다,거부하다|SAT
answer|대답하다|대답하다,질문하다,무시하다,침묵하다|SAT
ask|묻다|묻다,대답하다,침묵하다,무시하다|SAT
tell|말하다|말하다,숨기다,침묵하다,듣다|SAT
say|말하다|말하다,침묵하다,듣다,쓰다|SAT
talk|말하다|말하다,듣다,침묵하다,쓰다|SAT
explain|설명하다|설명하다,숨기다,혼란시키다,무시하다|SAT
describe|묘사하다|묘사하다,숨기다,무시하다,왜곡하다|SAT
show|보여주다|보여주다,숨기다,가리다,무시하다|SAT
point|가리키다|가리키다,숨기다,무시하다,피하다|SAT
draw|그리다|그리다,지우다,숨기다,파괴하다|SAT
paint|그리다|그리다,지우다,덮다,숨기다|SAT
cut|자르다|자르다,붙이다,연결하다,합치다|SAT
tie|묶다|묶다,풀다,끊다,분리하다|SAT
hang|걸다|걸다,내리다,놓다,떨어뜨리다|SAT
fill|채우다|채우다,비우다,버리다,제거하다|SAT
empty|비우다|비우다,채우다,가득채우다,보관하다|SAT
pour|붓다|붓다,비우다,저장하다,보관하다|SAT
drink|마시다|마시다,붓다,버리다,저장하다|SAT
eat|먹다|먹다,토하다,거부하다,버리다|SAT
cook|요리하다|요리하다,먹다,버리다,주문하다|SAT
burn|태우다|태우다,끄다,식히다,얼리다|SAT
shine|빛나다|빛나다,어두워지다,가리다,숨기다|SAT
grow|자라다|자라다,죽다,줄다,사라지다|SAT
plant|심다|심다,뽑다,자르다,버리다|SAT
dig|파다|파다,메우다,덮다,건설하다|SAT
pick|따다|따다,심다,버리다,숨기다|SAT
collect|모으다|모으다,흩어지다,버리다,잃다|SAT
choose|선택하다|선택하다,거부하다,버리다,무시하다|SAT
find|찾다|찾다,잃다,숨기다,버리다|SAT
lose|잃다|잃다,찾다,얻다,보관하다|SAT
search|찾다|찾다,숨기다,무시하다,포기하다|SAT
discover|발견하다|발견하다,잃다,숨기다,무시하다|SAT
hide|숨기다|숨기다,보여주다,드러내다,발견하다|SAT
save|구하다|구하다,버리다,잃다,파괴하다|SAT
protect|보호하다|보호하다,공격하다,파괴하다,해치다|SAT
attack|공격하다|공격하다,보호하다,방어하다,피하다|SAT
fight|싸우다|싸우다,평화롭다,협력하다,돕다|SAT
win|이기다|이기다,지다,포기하다,항복하다|SAT
lose|지다|지다,이기다,승리하다,성공하다|SAT
beat|이기다|이기다,지다,돕다,협력하다|SAT
hit|때리다|때리다,어루만지다,보호하다,돕다|SAT
kick|차다|차다,안다,어루만지다,보호하다|SAT
kill|죽이다|죽이다,살리다,구하다,보호하다|SAT
die|죽다|죽다,살다,생존하다,번성하다|SAT
live|살다|살다,죽다,떠나다,사라지다|SAT
stay|머무르다|머무르다,떠나다,가다,이동하다|SAT
leave|떠나다|떠나다,머무르다,오다,도착하다|SAT
arrive|도착하다|도착하다,떠나다,출발하다,피하다|SAT
reach|도착하다|도착하다,떠나다,출발하다,피하다|SAT
enter|들어가다|들어가다,나가다,떠나다,피하다|SAT
exit|나가다|나가다,들어가다,머무르다,오다|SAT
follow|따르다|따르다,이끌다,거부하다,피하다|SAT
lead|이끌다|이끌다,따르다,복종하다,피하다|SAT
guide|안내하다|안내하다,따르다,혼란시키다,잃다|SAT
join|참가하다|참가하다,떠나다,거부하다,피하다|SAT
meet|만나다|만나다,떠나다,피하다,헤어지다|SAT
greet|인사하다|인사하다,무시하다,피하다,작별하다|SAT
welcome|환영하다|환영하다,거부하다,쫓아내다,무시하다|SAT
invite|초대하다|초대하다,거부하다,쫓아내다,피하다|SAT
visit|방문하다|방문하다,피하다,떠나다,무시하다|SAT
travel|여행하다|여행하다,머무르다,정착하다,살다|SAT
ride|타다|타다,내리다,걷다,피하다|SAT
drive|운전하다|운전하다,걷다,타다,멈추다|SAT
park|주차하다|주차하다,운전하다,이동하다,떠나다|SAT
wait|기다리다|기다리다,떠나다,서두르다,포기하다|SAT
hurry|서두르다|서두르다,기다리다,천천히하다,멈추다|SAT
rush|서두르다|서두르다,천천히하다,기다리다,멈추다|SAT
rest|쉬다|쉬다,일하다,움직이다,활동하다|SAT
relax|휴식하다|휴식하다,긴장하다,일하다,걱정하다|SAT
play|놀다|놀다,일하다,공부하다,쉬다|SAT
work|일하다|일하다,놀다,쉬다,자다|SAT
exercise|운동하다|운동하다,쉬다,자다,앉아있다|SAT
practice|연습하다|연습하다,포기하다,놀다,쉬다|SAT
train|훈련하다|훈련하다,쉬다,놀다,포기하다|SAT
compete|경쟁하다|경쟁하다,협력하다,돕다,포기하다|SAT
race|경주하다|경주하다,걷다,쉬다,멈추다|SAT
shoot|쏘다|쏘다,받다,보호하다,피하다|SAT
score|득점하다|득점하다,잃다,실패하다,놓치다|SAT
pass|통과하다|통과하다,막다,실패하다,떨어지다|SAT
fail|실패하다|실패하다,성공하다,통과하다,이기다|SAT
succeed|성공하다|성공하다,실패하다,포기하다,지다|SAT
improve|향상시키다|향상시키다,악화시키다,파괴하다,유지하다|SAT
increase|증가하다|증가하다,감소하다,유지하다,줄다|SAT
decrease|감소하다|감소하다,증가하다,확대하다,늘다|SAT
reduce|줄이다|줄이다,늘리다,증가시키다,확대하다|SAT
add|더하다|더하다,빼다,나누다,곱하다|SAT
subtract|빼다|빼다,더하다,곱하다,나누다|SAT
multiply|곱하다|곱하다,나누다,더하다,빼다|SAT
divide|나누다|나누다,곱하다,더하다,합치다|SAT
count|세다|세다,무시하다,추측하다,잊다|SAT
measure|측정하다|측정하다,추측하다,무시하다,잊다|SAT
weigh|무게를재다|무게를재다,추측하다,버리다,무시하다|SAT
compare|비교하다|비교하다,무시하다,일치시키다,혼동하다|SAT
match|맞추다|맞추다,분리하다,반대하다,혼동하다|SAT
fit|맞다|맞다,맞지않다,크다,작다|SAT
suit|어울리다|어울리다,어울리지않다,반대하다,충돌하다|SAT
wear|입다|입다,벗다,버리다,던지다|SAT
dress|옷입히다|옷입히다,벗기다,드러내다,숨기다|SAT
change|바꾸다|바꾸다,유지하다,보존하다,고정하다|SAT
turn|변하다|변하다,유지하다,머무르다,고정하다|SAT
become|되다|되다,멈추다,유지하다,거부하다|SAT
remain|남다|남다,떠나다,사라지다,변하다|SAT
stay|머무르다|머무르다,떠나다,변하다,이동하다|SAT
appear|나타나다|나타나다,사라지다,숨다,피하다|SAT
disappear|사라지다|사라지다,나타나다,보이다,드러나다|SAT
seem|보이다|보이다,사실이다,확실하다,명백하다|SAT
look|보이다|보이다,숨기다,가리다,사라지다|SAT
sound|들리다|들리다,침묵하다,조용하다,멈추다|SAT
smell|냄새나다|냄새나다,무취하다,신선하다,깨끗하다|SAT
feel|느끼다|느끼다,무감각하다,무시하다,모르다|SAT
happen|일어나다|일어나다,막다,방지하다,피하다|SAT
occur|발생하다|발생하다,막다,방지하다,사라지다|SAT
exist|존재하다|존재하다,사라지다,없어지다,죽다|SAT
miss|그리워하다|그리워하다,싫어하다,잊다,무시하다|SAT
care|돌보다|돌보다,무시하다,해치다,버리다|SAT
worry|걱정하다|걱정하다,안심하다,무시하다,즐기다|SAT
fear|두려워하다|두려워하다,용감하다,환영하다,즐기다|SAT
surprise|놀라게하다|놀라게하다,예상하다,지루하게하다,무시하다|SAT
shock|충격주다|충격주다,진정시키다,예상하다,무시하다|SAT
amaze|놀라게하다|놀라게하다,지루하게하다,예상하다,무시하다|SAT
please|기쁘게하다|기쁘게하다,화나게하다,슬프게하다,실망시키다|SAT
satisfy|만족시키다|만족시키다,실망시키다,화나게하다,좌절시키다|SAT
disappoint|실망시키다|실망시키다,기쁘게하다,만족시키다,고무시키다|SAT
hurt|다치게하다|다치게하다,치료하다,돕다,보호하다|SAT
injure|다치게하다|다치게하다,치료하다,보호하다,구하다|SAT
harm|해치다|해치다,돕다,보호하다,치료하다|SAT
damage|손상시키다|손상시키다,고치다,보호하다,개선하다|SAT
repair|수리하다|수리하다,파괴하다,깨다,손상시키다|SAT
mend|고치다|고치다,깨다,파괴하다,손상시키다|SAT
clean|청소하다|청소하다,더럽히다,오염시키다,망치다|SAT
wash|씻다|씻다,더럽히다,오염시키다,말리다|SAT
dry|말리다|말리다,적시다,씻다,젖게하다|SAT
wipe|닦다|닦다,더럽히다,적시다,버리다|SAT
sweep|쓸다|쓸다,흩어지다,버리다,더럽히다|SAT
dust|먼지털다|먼지털다,더럽히다,흩어지다,버리다|SAT
polish|닦다|닦다,더럽히다,흐리게하다,손상시키다|SAT
fold|접다|접다,펴다,구기다,찢다|SAT
unfold|펴다|펴다,접다,구기다,숨기다|SAT
wrap|싸다|싸다,펴다,열다,드러내다|SAT
unwrap|풀다|풀다,싸다,숨기다,덮다|SAT
pack|싸다|싸다,풀다,버리다,흩어지다|SAT
unpack|풀다|풀다,싸다,정리하다,버리다|SAT
arrange|배열하다|배열하다,흩어지다,혼란시키다,버리다|SAT
organize|조직하다|조직하다,흩어지다,혼란시키다,파괴하다|SAT
plan|계획하다|계획하다,즉흥하다,포기하다,무시하다|SAT
prepare|준비하다|준비하다,포기하다,무시하다,파괴하다|SAT
decide|결정하다|결정하다,망설이다,포기하다,의심하다|SAT
determine|결심하다|결심하다,의심하다,포기하다,망설이다|SAT
intend|의도하다|의도하다,포기하다,우연히하다,실수하다|SAT
mean|의미하다|의미하다,무의미하다,숨기다,혼란시키다|SAT
matter|중요하다|중요하다,중요하지않다,무의미하다,사소하다|SAT
concern|관련되다|관련되다,무관하다,무시하다,피하다|SAT
belong|속하다|속하다,떠나다,분리되다,독립하다|SAT
own|소유하다|소유하다,빌리다,빌려주다,잃다|SAT
possess|소유하다|소유하다,빌리다,잃다,거부하다|SAT
contain|포함하다|포함하다,제외하다,비우다,거부하다|SAT
include|포함하다|포함하다,제외하다,거부하다,분리하다|SAT
consist|구성되다|구성되다,분리되다,제외하다,없어지다|SAT
depend|의존하다|의존하다,독립하다,거부하다,피하다|SAT
rely|의지하다|의지하다,독립하다,거부하다,무시하다|SAT
trust|신뢰하다|신뢰하다,의심하다,거부하다,배신하다|SAT
doubt|의심하다|의심하다,신뢰하다,확신하다,믿다|SAT
suppose|가정하다|가정하다,확인하다,증명하다,알다|SAT
assume|추정하다|추정하다,확인하다,증명하다,알다|SAT
expect|기대하다|기대하다,놀라다,의심하다,포기하다|SAT
imagine|상상하다|상상하다,알다,확인하다,증명하다|SAT
realize|깨닫다|깨닫다,모르다,무시하다,잊다|SAT
recognize|인식하다|인식하다,무시하다,모르다,잊다|SAT
admit|인정하다|인정하다,부인하다,거부하다,숨기다|SAT
deny|부인하다|부인하다,인정하다,확인하다,동의하다|SAT
accept|받아들이다|받아들이다,거부하다,거절하다,피하다|SAT
refuse|거부하다|거부하다,받아들이다,동의하다,환영하다|SAT
reject|거절하다|거절하다,받아들이다,환영하다,선택하다|SAT
agree|동의하다|동의하다,반대하다,거부하다,싸우다|SAT
disagree|반대하다|반대하다,동의하다,찬성하다,지지하다|SAT
promise|약속하다|약속하다,거부하다,배신하다,잊다|SAT
swear|맹세하다|맹세하다,거부하다,부인하다,배신하다|SAT
apologize|사과하다|사과하다,비난하다,거부하다,자랑하다|SAT
forgive|용서하다|용서하다,비난하다,처벌하다,복수하다|SAT
excuse|변명하다|변명하다,비난하다,책임지다,인정하다|SAT
blame|비난하다|비난하다,칭찬하다,용서하다,변명하다|SAT
praise|칭찬하다|칭찬하다,비난하다,무시하다,꾸짖다|SAT
thank|감사하다|감사하다,비난하다,무시하다,불평하다|SAT
congratulate|축하하다|축하하다,애도하다,무시하다,비난하다|SAT
celebrate|축하하다|축하하다,애도하다,무시하다,슬퍼하다|SAT
complain|불평하다|불평하다,칭찬하다,감사하다,만족하다|SAT
argue|논쟁하다|논쟁하다,동의하다,침묵하다,화해하다|SAT
quarrel|다투다|다투다,화해하다,평화롭다,동의하다|SAT
discuss|논의하다|논의하다,무시하다,침묵하다,숨기다|SAT
mention|언급하다|언급하다,무시하다,숨기다,잊다|SAT
suggest|제안하다|제안하다,거부하다,반대하다,무시하다|SAT
recommend|추천하다|추천하다,반대하다,거부하다,경고하다|SAT
advise|조언하다|조언하다,명령하다,무시하다,거부하다|SAT
warn|경고하다|경고하다,격려하다,무시하다,숨기다|SAT
remind|상기시키다|상기시키다,잊게하다,무시하다,숨기다|SAT
inform|알리다|알리다,숨기다,무시하다,속이다|SAT
announce|발표하다|발표하다,숨기다,취소하다,부인하다|SAT
declare|선언하다|선언하다,숨기다,부인하다,취소하다|SAT
claim|주장하다|주장하다,부인하다,의심하다,포기하다|SAT
state|진술하다|진술하다,숨기다,부인하다,의심하다|SAT
express|표현하다|표현하다,숨기다,억제하다,무시하다|SAT
communicate|의사소통하다|의사소통하다,침묵하다,숨기다,무시하다|SAT