abstract|추상적인|추상적인,구체적인,명확한,실제의|TOEFL
concrete|구체적인|구체적인,추상적인,모호한,불명확한|TOEFL
vague|모호한|모호한,명확한,분명한,확실한|TOEFL
ambiguous|애매한|애매한,명확한,분명한,확실한|TOEFL
obscure|불분명한|불분명한,명확한,뚜렷한,분명한|TOEFL
explicit|명시적인|명시적인,암시적인,모호한,불분명한|TOEFL
implicit|암시적인|암시적인,명시적인,명확한,분명한|TOEFL
apparent|명백한|명백한,숨겨진,불분명한,모호한|TOEFL
evident|분명한|분명한,불분명한,의심스러운,모호한|TOEFL
obvious|명백한|명백한,불분명한,숨겨진,모호한|TOEFL
manifest|명백한|명백한,숨겨진,불분명한,잠재적인|TOEFL
visible|보이는|보이는,보이지않는,숨겨진,잠재적인|TOEFL
invisible|보이지않는|보이지않는,보이는,명백한,드러난|TOEFL
transparent|투명한|투명한,불투명한,흐린,숨겨진|TOEFL
opaque|불투명한|불투명한,투명한,맑은,명확한|TOEFL
lucid|명료한|명료한,혼란스러운,불분명한,모호한|TOEFL
intelligible|이해할수있는|이해할수있는,이해불가능한,혼란스러운,모호한|TOEFL
comprehensible|이해할수있는|이해할수있는,이해불가능한,복잡한,난해한|TOEFL
accessible|접근가능한|접근가능한,접근불가능한,막힌,폐쇄된|TOEFL
available|이용가능한|이용가능한,이용불가능한,결핍된,없는|TOEFL
obtainable|얻을수있는|얻을수있는,얻을수없는,불가능한,금지된|TOEFL
attainable|달성가능한|달성가능한,달성불가능한,불가능한,먼|TOEFL
feasible|실행가능한|실행가능한,실행불가능한,불가능한,비현실적인|TOEFL
practicable|실용적인|실용적인,비실용적인,불가능한,이론적인|TOEFL
viable|실행가능한|실행가능한,실행불가능한,불가능한,죽은|TOEFL
workable|실행가능한|실행가능한,실행불가능한,불가능한,실패한|TOEFL
possible|가능한|가능한,불가능한,안되는,금지된|TOEFL
probable|가능성있는|가능성있는,불가능한,거의없는,확실한|TOEFL
likely|가능성있는|가능성있는,불가능한,거의없는,확실한|TOEFL
potential|잠재적인|잠재적인,실제의,명백한,현실화된|TOEFL
latent|잠재적인|잠재적인,명백한,활동적인,표면적인|TOEFL
dormant|휴면상태의|휴면상태의,활동적인,깨어있는,활발한|TOEFL
inherent|내재하는|내재하는,외부의,부가된,인위적인|TOEFL
innate|타고난|타고난,학습된,후천적인,인위적인|TOEFL
intrinsic|본질적인|본질적인,외적인,부차적인,표면적인|TOEFL
extrinsic|외적인|외적인,내재적인,본질적인,고유한|TOEFL
fundamental|근본적인|근본적인,부차적인,표면적인,사소한|TOEFL
essential|본질적인|본질적인,부차적인,불필요한,사소한|TOEFL
vital|필수적인|필수적인,불필요한,사소한,선택적인|TOEFL
crucial|결정적인|결정적인,사소한,불필요한,무의미한|TOEFL
critical|중대한|중대한,사소한,불필요한,무의미한|TOEFL
significant|의미있는|의미있는,무의미한,사소한,무관한|TOEFL
substantial|상당한|상당한,미미한,사소한,불충분한|TOEFL
considerable|상당한|상당한,사소한,미미한,불충분한|TOEFL
enormous|막대한|막대한,미미한,작은,불충분한|TOEFL
immense|거대한|거대한,미미한,작은,제한된|TOEFL
vast|광대한|광대한,좁은,작은,제한된|TOEFL
extensive|광범위한|광범위한,제한된,좁은,국지적인|TOEFL
comprehensive|포괄적인|포괄적인,제한적인,부분적인,불완전한|TOEFL
thorough|철저한|철저한,피상적인,불완전한,부주의한|TOEFL
exhaustive|철저한|철저한,불완전한,피상적인,선택적인|TOEFL
meticulous|세심한|세심한,부주의한,대충하는,무관심한|TOEFL
scrupulous|꼼꼼한|꼼꼼한,부주의한,무관심한,부정직한|TOEFL
conscientious|양심적인|양심적인,무책임한,부주의한,태만한|TOEFL
diligent|부지런한|부지런한,게으른,태만한,무관심한|TOEFL
industrious|근면한|근면한,게으른,나태한,무관심한|TOEFL
assiduous|근면한|근면한,게으른,태만한,간헐적인|TOEFL
persistent|끈기있는|끈기있는,포기하는,변덕스러운,일시적인|TOEFL
persevering|인내하는|인내하는,포기하는,변덕스러운,약한|TOEFL
tenacious|완강한|완강한,약한,포기하는,유연한|TOEFL
steadfast|확고한|확고한,변덕스러운,불안정한,동요하는|TOEFL
resolute|단호한|단호한,우유부단한,망설이는,약한|TOEFL
determined|결연한|결연한,우유부단한,포기하는,약한|TOEFL
firm|확고한|확고한,불확실한,동요하는,약한|TOEFL
unwavering|흔들리지않는|흔들리지않는,동요하는,불안정한,변덕스러운|TOEFL
stable|안정된|안정된,불안정한,변화하는,동요하는|TOEFL
steady|안정된|안정된,불안정한,변화무쌍한,동요하는|TOEFL
constant|일정한|일정한,변화하는,불규칙한,간헐적인|TOEFL
consistent|일관된|일관된,모순된,변덕스러운,불규칙한|TOEFL
uniform|균일한|균일한,불균일한,다양한,불규칙한|TOEFL
homogeneous|동질의|동질의,이질의,다양한,혼합된|TOEFL
heterogeneous|이질의|이질의,동질의,균일한,단일한|TOEFL
diverse|다양한|다양한,단일한,균일한,동일한|TOEFL
varied|다양한|다양한,단일한,균일한,일정한|TOEFL
miscellaneous|다양한|다양한,단일한,균일한,동질의|TOEFL
assorted|여러가지의|여러가지의,단일한,균일한,동일한|TOEFL
multiple|다수의|다수의,단일의,하나의,유일한|TOEFL
numerous|많은|많은,소수의,적은,거의없는|TOEFL
abundant|풍부한|풍부한,부족한,희소한,결핍된|TOEFL
plentiful|풍부한|풍부한,부족한,희소한,결핍된|TOEFL
copious|풍부한|풍부한,부족한,적은,불충분한|TOEFL
ample|충분한|충분한,부족한,불충분한,결핍된|TOEFL
sufficient|충분한|충분한,불충분한,부족한,결핍된|TOEFL
adequate|적절한|적절한,부족한,불충분한,과도한|TOEFL
deficient|부족한|부족한,충분한,과도한,풍부한|TOEFL
insufficient|불충분한|불충분한,충분한,과도한,풍부한|TOEFL
scarce|부족한|부족한,풍부한,충분한,과도한|TOEFL
sparse|드문|드문,빽빽한,밀집한,풍부한|TOEFL
meager|빈약한|빈약한,풍부한,충분한,과도한|TOEFL
scanty|부족한|부족한,풍부한,충분한,과도한|TOEFL
scant|부족한|부족한,풍부한,충분한,과도한|TOEFL
bare|최소한의|최소한의,풍부한,과도한,충분한|TOEFL
minimal|최소의|최소의,최대의,과도한,충분한|TOEFL
marginal|한계의|한계의,중심적인,주요한,충분한|TOEFL
negligible|무시할만한|무시할만한,중요한,상당한,주요한|TOEFL
trivial|사소한|사소한,중요한,중대한,본질적인|TOEFL
insignificant|중요하지않은|중요하지않은,중요한,주요한,본질적인|TOEFL
petty|사소한|사소한,중요한,중대한,본질적인|TOEFL
trifling|하찮은|하찮은,중요한,중대한,본질적인|TOEFL
minor|사소한|사소한,주요한,중대한,본질적인|TOEFL
subordinate|부차적인|부차적인,주요한,우선적인,중심적인|TOEFL
secondary|이차적인|이차적인,주요한,우선적인,핵심적인|TOEFL
auxiliary|보조의|보조의,주요한,핵심적인,필수적인|TOEFL
supplementary|보충의|보충의,주요한,핵심적인,필수적인|TOEFL
additional|추가의|추가의,기본의,필수적인,원래의|TOEFL
extra|추가의|추가의,기본의,필수적인,표준의|TOEFL
surplus|잉여의|잉여의,부족한,필수적인,기본적인|TOEFL
redundant|불필요한|불필요한,필수적인,중요한,핵심적인|TOEFL
superfluous|불필요한|불필요한,필수적인,중요한,부족한|TOEFL
excessive|과도한|과도한,부족한,적절한,적당한|TOEFL
extreme|극단적인|극단적인,온건한,적당한,중간의|TOEFL
radical|급진적인|급진적인,보수적인,온건한,중도의|TOEFL
drastic|과격한|과격한,온건한,점진적인,부드러운|TOEFL
severe|극심한|극심한,온화한,약한,부드러운|TOEFL
intense|강렬한|강렬한,약한,온화한,부드러운|TOEFL
acute|심각한|심각한,가벼운,온화한,약한|TOEFL
chronic|만성적인|만성적인,급성의,일시적인,짧은|TOEFL
persistent|지속적인|지속적인,일시적인,간헐적인,짧은|TOEFL
prolonged|장기간의|장기간의,짧은,일시적인,순간적인|TOEFL
extended|연장된|연장된,짧아진,제한된,축소된|TOEFL
perpetual|영구적인|영구적인,일시적인,짧은,순간적인|TOEFL
eternal|영원한|영원한,일시적인,유한한,끝나는|TOEFL
infinite|무한한|무한한,유한한,제한된,끝나는|TOEFL
endless|끝없는|끝없는,유한한,제한된,짧은|TOEFL
boundless|무한한|무한한,제한된,경계있는,유한한|TOEFL
unlimited|무제한의|무제한의,제한된,경계있는,유한한|TOEFL
unrestricted|제한없는|제한없는,제한된,제약된,통제된|TOEFL
unconditional|무조건적인|무조건적인,조건적인,제한적인,선택적인|TOEFL
absolute|절대적인|절대적인,상대적인,조건적인,부분적인|TOEFL
complete|완전한|완전한,불완전한,부분적인,결함있는|TOEFL
total|전체의|전체의,부분적인,불완전한,일부의|TOEFL
entire|전체의|전체의,부분적인,불완전한,일부의|TOEFL
whole|완전한|완전한,부분적인,불완전한,결함있는|TOEFL
intact|손상되지않은|손상되지않은,손상된,파괴된,불완전한|TOEFL
integrated|통합된|통합된,분리된,독립된,분산된|TOEFL
unified|통일된|통일된,분열된,분산된,독립된|TOEFL
cohesive|결속력있는|결속력있는,분열된,분산된,독립된|TOEFL
coherent|일관성있는|일관성있는,모순된,분산된,혼란스러운|TOEFL
logical|논리적인|논리적인,비논리적인,불합리한,모순된|TOEFL
rational|합리적인|합리적인,비합리적인,불합리한,감정적인|TOEFL
reasonable|합리적인|합리적인,불합리한,터무니없는,극단적인|TOEFL
sensible|분별있는|분별있는,어리석은,무분별한,비합리적인|TOEFL
prudent|신중한|신중한,무모한,경솔한,무분별한|TOEFL
cautious|조심스러운|조심스러운,무모한,경솔한,대담한|TOEFL
careful|조심스러운|조심스러운,부주의한,무모한,경솔한|TOEFL
wary|경계하는|경계하는,방심하는,무방비의,신뢰하는|TOEFL
vigilant|경계하는|경계하는,방심하는,무관심한,부주의한|TOEFL
alert|경계하는|경계하는,방심하는,무관심한,졸린|TOEFL
watchful|주의깊은|주의깊은,부주의한,무관심한,방심하는|TOEFL
attentive|주의깊은|주의깊은,부주의한,무관심한,산만한|TOEFL
observant|관찰력있는|관찰력있는,무관심한,무시하는,부주의한|TOEFL
perceptive|통찰력있는|통찰력있는,둔감한,무지한,무관심한|TOEFL
discerning|식별력있는|식별력있는,무분별한,둔감한,무지한|TOEFL
astute|영리한|영리한,어리석은,둔한,무지한|TOEFL
shrewd|빈틈없는|빈틈없는,어리석은,순진한,둔한|TOEFL
keen|예리한|예리한,둔한,무딘,무관심한|TOEFL
sharp|날카로운|날카로운,둔한,무딘,부드러운|TOEFL
acute|예리한|예리한,둔한,무관심한,무지한|TOEFL
penetrating|꿰뚫는|꿰뚫는,피상적인,둔한,무지한|TOEFL
profound|심오한|심오한,피상적인,얕은,단순한|TOEFL
deep|깊은|깊은,얕은,피상적인,단순한|TOEFL
shallow|얕은|얕은,깊은,심오한,복잡한|TOEFL
superficial|피상적인|피상적인,심오한,깊은,철저한|TOEFL
cursory|대충하는|대충하는,철저한,세밀한,꼼꼼한|TOEFL
hasty|성급한|성급한,신중한,느린,조심스러운|TOEFL
rash|경솔한|경솔한,신중한,조심스러운,사려깊은|TOEFL
impulsive|충동적인|충동적인,신중한,계획적인,사려깊은|TOEFL
spontaneous|자발적인|자발적인,계획된,강제된,의무적인|TOEFL
voluntary|자발적인|자발적인,강제적인,의무적인,필수적인|TOEFL
deliberate|의도적인|의도적인,우연한,실수의,무의식적인|TOEFL
intentional|고의적인|고의적인,우연한,실수의,무의식적인|TOEFL
purposeful|의도적인|의도적인,우연한,무의미한,무목적의|TOEFL
conscious|의식적인|의식적인,무의식적인,자동적인,본능적인|TOEFL
aware|인식하는|인식하는,무지한,모르는,무의식적인|TOEFL
cognizant|인식하는|인식하는,무지한,모르는,무관심한|TOEFL
mindful|유념하는|유념하는,무관심한,부주의한,망각하는|TOEFL
heedful|주의하는|주의하는,무관심한,부주의한,무시하는|TOEFL
regardful|배려하는|배려하는,무관심한,무시하는,무례한|TOEFL
considerate|사려깊은|사려깊은,무신경한,무례한,이기적인|TOEFL
thoughtful|사려깊은|사려깊은,경솔한,무신경한,이기적인|TOEFL
compassionate|동정심많은|동정심많은,무정한,냉담한,잔인한|TOEFL
sympathetic|동정적인|동정적인,무정한,냉담한,적대적인|TOEFL
empathetic|공감하는|공감하는,무감각한,냉담한,무관심한|TOEFL
tender|다정한|다정한,무정한,거친,잔인한|TOEFL
gentle|온화한|온화한,거친,사나운,폭력적인|TOEFL
mild|온화한|온화한,거친,극심한,격렬한|TOEFL
moderate|온건한|온건한,극단적인,격렬한,과격한|TOEFL
temperate|절제하는|절제하는,극단적인,과도한,무절제한|TOEFL
restrained|절제된|절제된,방종한,과도한,무절제한|TOEFL
reserved|절제된|절제된,개방적인,솔직한,수다스러운|TOEFL
modest|겸손한|겸손한,거만한,자만하는,오만한|TOEFL
humble|겸손한|겸손한,거만한,오만한,자만하는|TOEFL
unassuming|겸손한|겸손한,거만한,오만한,주제넘은|TOEFL
meek|온순한|온순한,거만한,공격적인,대담한|TOEFL
submissive|복종적인|복종적인,반항적인,대담한,지배적인|TOEFL
obedient|순종하는|순종하는,반항적인,거역하는,불복종하는|TOEFL
compliant|순응하는|순응하는,반항적인,저항하는,불복종하는|TOEFL
docile|온순한|온순한,반항적인,고집센,완고한|TOEFL
tractable|다루기쉬운|다루기쉬운,다루기어려운,완고한,반항적인|TOEFL
amenable|순응하는|순응하는,완고한,반항적인,저항하는|TOEFL
flexible|유연한|유연한,완고한,경직된,고집센|TOEFL
adaptable|적응력있는|적응력있는,경직된,완고한,적응못하는|TOEFL
versatile|다재다능한|다재다능한,한가지만하는,제한적인,무능한|TOEFL
resourceful|기지있는|기지있는,무능한,의지없는,무기력한|TOEFL
ingenious|독창적인|독창적인,평범한,진부한,창의성없는|TOEFL
inventive|창의적인|창의적인,평범한,모방적인,진부한|TOEFL
imaginative|상상력풍부한|상상력풍부한,평범한,창의성없는,둔한|TOEFL
creative|창의적인|창의적인,평범한,모방적인,파괴적인|TOEFL
innovative|혁신적인|혁신적인,전통적인,보수적인,진부한|TOEFL
pioneering|선구적인|선구적인,뒤따르는,모방하는,보수적인|TOEFL
progressive|진보적인|진보적인,보수적인,퇴보적인,정체된|TOEFL
advanced|진보된|진보된,후진적인,낙후된,원시적인|TOEFL
sophisticated|세련된|세련된,조잡한,단순한,미숙한|TOEFL
refined|세련된|세련된,조잡한,거친,미숙한|TOEFL
cultivated|교양있는|교양있는,교양없는,무식한,거친|TOEFL
cultured|교양있는|교양있는,교양없는,무지한,야만적인|TOEFL
civilized|문명화된|문명화된,야만적인,원시적인,미개한|TOEFL
polished|세련된|세련된,거친,조잡한,미숙한|TOEFL
elegant|우아한|우아한,조잡한,거친,촌스러운|TOEFL
graceful|우아한|우아한,어색한,투박한,서툰|TOEFL
exquisite|정교한|정교한,조잡한,거친,저속한|TOEFL
delicate|섬세한|섬세한,거친,둔감한,조잡한|TOEFL
subtle|미묘한|미묘한,명백한,노골적인,거친|TOEFL
nuanced|뉘앙스있는|뉘앙스있는,단순한,명백한,거친|TOEFL
intricate|복잡한|복잡한,단순한,쉬운,조잡한|TOEFL
elaborate|정교한|정교한,단순한,조잡한,기본적인|TOEFL
complex|복잡한|복잡한,단순한,쉬운,기본적인|TOEFL
complicated|복잡한|복잡한,단순한,쉬운,명확한|TOEFL
convoluted|복잡한|복잡한,단순한,명확한,직접적인|TOEFL
tangled|얽힌|얽힌,풀린,명확한,단순한|TOEFL
confused|혼란스러운|혼란스러운,명확한,정리된,단순한|TOEFL
chaotic|혼란스러운|혼란스러운,질서있는,정돈된,체계적인|TOEFL
disorderly|무질서한|무질서한,질서있는,정돈된,체계적인|TOEFL
messy|지저분한|지저분한,깔끔한,정돈된,깨끗한|TOEFL
cluttered|어지러운|어지러운,깔끔한,정돈된,정리된|TOEFL
untidy|정돈안된|정돈안된,깔끔한,정돈된,정리된|TOEFL
sloppy|엉성한|엉성한,깔끔한,정확한,완벽한|TOEFL
careless|부주의한|부주의한,조심스러운,신중한,세심한|TOEFL
negligent|태만한|태만한,성실한,책임감있는,신중한|TOEFL
reckless|무모한|무모한,신중한,조심스러운,사려깊은|TOEFL
heedless|부주의한|부주의한,주의깊은,조심스러운,신중한|TOEFL
indifferent|무관심한|무관심한,관심있는,열정적인,열심인|TOEFL
apathetic|무관심한|무관심한,열정적인,관심있는,적극적인|TOEFL
passive|수동적인|수동적인,능동적인,적극적인,활발한|TOEFL
inactive|비활동적인|비활동적인,활동적인,활발한,적극적인|TOEFL
idle|게으른|게으른,부지런한,활동적인,열심히하는|TOEFL
lazy|게으른|게으른,부지런한,근면한,성실한|TOEFL
sluggish|느린|느린,빠른,활발한,민첩한|TOEFL
lethargic|무기력한|무기력한,활기찬,활발한,에너지넘치는|TOEFL
listless|무기력한|무기력한,활기찬,열정적인,에너지넘치는|TOEFL
languid|나른한|나른한,활기찬,에너지넘치는,활발한|TOEFL
indolent|게으른|게으른,부지런한,근면한,활동적인|TOEFL
slothful|게으른|게으른,부지런한,근면한,열심히하는|TOEFL
contemplate|숙고하다|숙고하다,무시하다,즉흥적으로행동하다,잊다|SAT
ponder|숙고하다|숙고하다,무시하다,경솔히행동하다,잊다|SAT
meditate|명상하다|명상하다,무시하다,분산하다,혼란스러워하다|SAT
reflect|숙고하다|숙고하다,무시하다,행동하다,잊다|SAT
deliberate|숙고하다|숙고하다,즉흥적으로행동하다,무시하다,서두르다|SAT
ruminate|곰곰이생각하다|곰곰이생각하다,무시하다,잊다,서두르다|SAT
muse|곰곰이생각하다|곰곰이생각하다,무시하다,행동하다,잊다|SAT
speculate|추측하다|추측하다,확인하다,증명하다,알다|SAT
conjecture|추측하다|추측하다,확인하다,증명하다,알다|SAT
hypothesize|가설을세우다|가설을세우다,증명하다,확인하다,알다|SAT
theorize|이론화하다|이론화하다,증명하다,확인하다,실행하다|SAT
postulate|가정하다|가정하다,증명하다,확인하다,거부하다|SAT
presume|추정하다|추정하다,확인하다,증명하다,알다|SAT
assume|가정하다|가정하다,확인하다,증명하다,거부하다|SAT
suppose|가정하다|가정하다,확인하다,증명하다,알다|SAT
infer|추론하다|추론하다,확인하다,증명하다,무시하다|SAT
deduce|추론하다|추론하다,확인하다,추측하다,무시하다|SAT
derive|도출하다|도출하다,추측하다,무시하다,거부하다|SAT
conclude|결론짓다|결론짓다,시작하다,의심하다,계속하다|SAT
determine|결정하다|결정하다,망설이다,의심하다,포기하다|SAT
ascertain|확인하다|확인하다,추측하다,의심하다,무시하다|SAT
verify|확인하다|확인하다,의심하다,거부하다,부인하다|SAT
validate|입증하다|입증하다,무효화하다,거부하다,의심하다|SAT
substantiate|입증하다|입증하다,반박하다,거부하다,의심하다|SAT
corroborate|확증하다|확증하다,반박하다,부인하다,의심하다|SAT
authenticate|인증하다|인증하다,위조하다,거부하다,의심하다|SAT
certify|증명하다|증명하다,거부하다,의심하다,부인하다|SAT
attest|증명하다|증명하다,부인하다,의심하다,거부하다|SAT
testify|증언하다|증언하다,부인하다,침묵하다,거짓말하다|SAT
witness|목격하다|목격하다,놓치다,무시하다,피하다|SAT
observe|관찰하다|관찰하다,무시하다,놓치다,피하다|SAT
perceive|지각하다|지각하다,무시하다,놓치다,오해하다|SAT
discern|식별하다|식별하다,혼동하다,무시하다,놓치다|SAT
distinguish|구별하다|구별하다,혼동하다,일치시키다,통합하다|SAT
differentiate|구별하다|구별하다,통합하다,혼동하다,일치시키다|SAT
discriminate|차별하다|차별하다,평등하게대하다,통합하다,존중하다|SAT
segregate|분리하다|분리하다,통합하다,결합하다,혼합하다|SAT
isolate|고립시키다|고립시키다,통합하다,연결하다,결합하다|SAT
quarantine|격리하다|격리하다,통합하다,해방하다,연결하다|SAT
seclude|격리하다|격리하다,포함하다,통합하다,연결하다|SAT
confine|제한하다|제한하다,해방하다,확대하다,자유롭게하다|SAT
restrict|제한하다|제한하다,확대하다,자유롭게하다,허용하다|SAT
limit|제한하다|제한하다,확대하다,늘리다,자유롭게하다|SAT
constrain|제약하다|제약하다,자유롭게하다,확대하다,허용하다|SAT
restrain|억제하다|억제하다,장려하다,자유롭게하다,표현하다|SAT
inhibit|억제하다|억제하다,장려하다,자극하다,표현하다|SAT
hinder|방해하다|방해하다,돕다,촉진하다,장려하다|SAT
impede|방해하다|방해하다,돕다,촉진하다,가속화하다|SAT
obstruct|방해하다|방해하다,돕다,촉진하다,허용하다|SAT
hamper|방해하다|방해하다,돕다,촉진하다,장려하다|SAT
thwart|좌절시키다|좌절시키다,돕다,장려하다,성공시키다|SAT
frustrate|좌절시키다|좌절시키다,만족시키다,성공시키다,격려하다|SAT
foil|좌절시키다|좌절시키다,돕다,성공시키다,장려하다|SAT
stifle|억압하다|억압하다,장려하다,표현하다,자극하다|SAT
suppress|억압하다|억압하다,장려하다,표현하다,자유롭게하다|SAT
repress|억압하다|억압하다,표현하다,해방하다,장려하다|SAT
oppress|억압하다|억압하다,해방하다,자유롭게하다,격려하다|SAT
subjugate|정복하다|정복하다,해방하다,자유롭게하다,존중하다|SAT
subdue|진압하다|진압하다,장려하다,자극하다,해방하다|SAT
quell|진압하다|진압하다,장려하다,자극하다,선동하다|SAT
crush|짓밟다|짓밟다,돕다,보호하다,격려하다|SAT
overwhelm|압도하다|압도하다,격려하다,돕다,지원하다|SAT
overpower|제압하다|제압하다,돕다,지원하다,격려하다|SAT
overcome|극복하다|극복하다,항복하다,포기하다,굴복하다|SAT
surmount|극복하다|극복하다,항복하다,포기하다,실패하다|SAT
conquer|정복하다|정복하다,항복하다,패배하다,포기하다|SAT
vanquish|정복하다|정복하다,패배하다,항복하다,굴복하다|SAT
triumph|승리하다|승리하다,패배하다,항복하다,실패하다|SAT
prevail|이기다|이기다,지다,패배하다,항복하다|SAT
succeed|성공하다|성공하다,실패하다,포기하다,좌절하다|SAT
prosper|번영하다|번영하다,실패하다,쇠퇴하다,가난해지다|SAT
thrive|번성하다|번성하다,쇠퇴하다,시들다,죽다|SAT
flourish|번영하다|번영하다,쇠퇴하다,시들다,실패하다|SAT
bloom|꽃피다|꽃피다,시들다,죽다,쇠퇴하다|SAT
blossom|꽃피다|꽃피다,시들다,죽다,쇠퇴하다|SAT
burgeon|급성장하다|급성장하다,쇠퇴하다,줄어들다,사라지다|SAT
proliferate|급증하다|급증하다,감소하다,줄어들다,사라지다|SAT
multiply|증가하다|증가하다,감소하다,줄어들다,나누다|SAT
propagate|번식시키다|번식시키다,죽이다,억제하다,제거하다|SAT
reproduce|번식하다|번식하다,멸종하다,죽다,사라지다|SAT
generate|생성하다|생성하다,파괴하다,소멸시키다,억제하다|SAT
produce|생산하다|생산하다,소비하다,파괴하다,억제하다|SAT
yield|생산하다|생산하다,소비하다,억제하다,파괴하다|SAT
bear|낳다|낳다,죽이다,억제하다,파괴하다|SAT
spawn|낳다|낳다,죽이다,파괴하다,억제하다|SAT
breed|번식시키다|번식시키다,멸종시키다,죽이다,억제하다|SAT
cultivate|재배하다|재배하다,파괴하다,방치하다,억제하다|SAT
nurture|양육하다|양육하다,방치하다,학대하다,억제하다|SAT
foster|육성하다|육성하다,억제하다,방해하다,파괴하다|SAT
nourish|영양을공급하다|영양을공급하다,굶기다,억제하다,파괴하다|SAT
sustain|유지하다|유지하다,파괴하다,중단하다,억제하다|SAT
support|지원하다|지원하다,방해하다,억제하다,파괴하다|SAT
uphold|지지하다|지지하다,반대하다,억제하다,파괴하다|SAT
maintain|유지하다|유지하다,파괴하다,변경하다,포기하다|SAT
preserve|보존하다|보존하다,파괴하다,변경하다,낭비하다|SAT
conserve|보존하다|보존하다,낭비하다,파괴하다,소비하다|SAT
retain|보유하다|보유하다,잃다,버리다,포기하다|SAT
keep|유지하다|유지하다,잃다,버리다,포기하다|SAT
hold|보유하다|보유하다,놓다,버리다,잃다|SAT
possess|소유하다|소유하다,잃다,빌리다,포기하다|SAT
own|소유하다|소유하다,빌리다,잃다,빌려주다|SAT
belong|속하다|속하다,떠나다,분리되다,독립하다|SAT
pertain|관련되다|관련되다,무관하다,분리되다,독립하다|SAT
relate|관련시키다|관련시키다,분리하다,독립시키다,무관하게하다|SAT
associate|연관시키다|연관시키다,분리하다,독립시키다,배제하다|SAT
connect|연결하다|연결하다,분리하다,끊다,독립시키다|SAT
link|연결하다|연결하다,분리하다,끊다,독립시키다|SAT
bind|묶다|묶다,풀다,분리하다,해방하다|SAT
attach|붙이다|붙이다,떼다,분리하다,제거하다|SAT
affix|붙이다|붙이다,떼다,제거하다,분리하다|SAT
fasten|고정하다|고정하다,풀다,분리하다,떼다|SAT
secure|고정하다|고정하다,풀다,위험하게하다,해제하다|SAT
anchor|고정하다|고정하다,풀다,떠내려보내다,해방하다|SAT
moor|정박시키다|정박시키다,출항시키다,풀다,떠나보내다|SAT
tether|매다|매다,풀다,해방하다,자유롭게하다|SAT
tie|묶다|묶다,풀다,분리하다,해방하다|SAT
unite|결합하다|결합하다,분리하다,나누다,독립시키다|SAT
join|결합하다|결합하다,분리하다,나누다,떼다|SAT
merge|합병하다|합병하다,분리하다,나누다,독립하다|SAT
fuse|융합하다|융합하다,분리하다,나누다,독립시키다|SAT
blend|혼합하다|혼합하다,분리하다,나누다,순수하게하다|SAT
mingle|섞다|섞다,분리하다,나누다,격리하다|SAT
mix|섞다|섞다,분리하다,나누다,순수하게하다|SAT
amalgamate|합병하다|합병하다,분리하다,나누다,독립시키다|SAT
consolidate|통합하다|통합하다,분산시키다,나누다,분리하다|SAT
unify|통일하다|통일하다,분열시키다,나누다,분리하다|SAT
integrate|통합하다|통합하다,분리하다,독립시키다,배제하다|SAT
incorporate|통합하다|통합하다,분리하다,배제하다,독립시키다|SAT
embody|구현하다|구현하다,분리하다,배제하다,추상화하다|SAT
comprise|구성하다|구성하다,제외하다,배제하다,분리하다|SAT
constitute|구성하다|구성하다,파괴하다,해체하다,배제하다|SAT
compose|구성하다|구성하다,분해하다,파괴하다,배제하다|SAT
form|형성하다|형성하다,파괴하다,해체하다,분해하다|SAT
shape|형성하다|형성하다,파괴하다,변형하다,해체하다|SAT
mold|형성하다|형성하다,파괴하다,변형하다,해체하다|SAT
fashion|만들다|만들다,파괴하다,해체하다,무시하다|SAT
craft|제작하다|제작하다,파괴하다,해체하다,무시하다|SAT
forge|만들다|만들다,파괴하다,해체하다,진품을만들다|SAT
fabricate|제작하다|제작하다,파괴하다,해체하다,진실을말하다|SAT
manufacture|제조하다|제조하다,파괴하다,수입하다,소비하다|SAT
construct|건설하다|건설하다,파괴하다,철거하다,무너뜨리다|SAT
erect|세우다|세우다,무너뜨리다,파괴하다,눕히다|SAT
build|짓다|짓다,파괴하다,무너뜨리다,철거하다|SAT
assemble|조립하다|조립하다,분해하다,파괴하다,흩어지다|SAT
compile|편집하다|편집하다,분산시키다,파괴하다,흩어지다|SAT
accumulate|축적하다|축적하다,분산시키다,소비하다,낭비하다|SAT
amass|모으다|모으다,분산시키다,낭비하다,소비하다|SAT
gather|모으다|모으다,흩어지다,분산시키다,버리다|SAT
collect|수집하다|수집하다,흩어지다,버리다,분산시키다|SAT
aggregate|집합하다|집합하다,분산시키다,흩어지다,독립하다|SAT
congregate|모이다|모이다,흩어지다,분산하다,떠나다|SAT
assemble|모이다|모이다,해산하다,흩어지다,떠나다|SAT
convene|소집하다|소집하다,해산하다,흩어지다,보내다|SAT
summon|소환하다|소환하다,해산시키다,보내다,거부하다|SAT
muster|소집하다|소집하다,해산시키다,흩어지다,보내다|SAT
rally|집결시키다|집결시키다,흩어지다,분산시키다,해산시키다|SAT
mobilize|동원하다|동원하다,해산시키다,흩어지다,억제하다|SAT
marshal|집합시키다|집합시키다,흩어지다,분산시키다,해산시키다|SAT
deploy|배치하다|배치하다,철수시키다,흩어지다,모으다|SAT
station|배치하다|배치하다,이동시키다,철수시키다,흩어지다|SAT
position|배치하다|배치하다,이동시키다,제거하다,철수시키다|SAT
situate|위치시키다|위치시키다,이동시키다,제거하다,숨기다|SAT
locate|위치시키다|위치시키다,이동시키다,숨기다,잃다|SAT
place|놓다|놓다,이동시키다,제거하다,가져가다|SAT
set|놓다|놓다,이동시키다,제거하다,가져가다|SAT
lay|놓다|놓다,들다,이동시키다,제거하다|SAT
rest|놓다|놓다,들다,이동시키다,활동하다|SAT
repose|놓다|놓다,이동시키다,들다,활동하다|SAT
deposit|놓다|놓다,가져가다,제거하다,들다|SAT
lodge|놓다|놓다,제거하다,가져가다,이동시키다|SAT
install|설치하다|설치하다,제거하다,철거하다,분해하다|SAT
mount|설치하다|설치하다,제거하다,내리다,분해하다|SAT
fix|고정하다|고정하다,제거하다,이동시키다,풀다|SAT
implant|이식하다|이식하다,제거하다,추출하다,분리하다|SAT
embed|박다|박다,제거하다,추출하다,분리하다|SAT
insert|삽입하다|삽입하다,제거하다,추출하다,빼다|SAT
introduce|도입하다|도입하다,제거하다,배제하다,거부하다|SAT
inject|주입하다|주입하다,추출하다,제거하다,배출하다|SAT
infuse|주입하다|주입하다,추출하다,배출하다,제거하다|SAT
instill|주입하다|주입하다,제거하다,추출하다,배제하다|SAT
inculcate|주입하다|주입하다,제거하다,배제하다,잊게하다|SAT
implant|심다|심다,제거하다,추출하다,뽑다|SAT
engrave|새기다|새기다,지우다,제거하다,무시하다|SAT
inscribe|새기다|새기다,지우다,제거하다,무시하다|SAT
imprint|각인시키다|각인시키다,지우다,잊게하다,무시하다|SAT
impress|인상을주다|인상을주다,무시당하다,잊히다,실망시키다|SAT
stamp|찍다|찍다,지우다,제거하다,무시하다|SAT
mark|표시하다|표시하다,지우다,숨기다,무시하다|SAT
label|표시하다|표시하다,제거하다,숨기다,무시하다|SAT
tag|표시하다|표시하다,제거하다,숨기다,무시하다|SAT
designate|지정하다|지정하다,제거하다,배제하다,무시하다|SAT
identify|확인하다|확인하다,숨기다,혼동하다,무시하다|SAT
recognize|인식하다|인식하다,무시하다,혼동하다,잊다|SAT
acknowledge|인정하다|인정하다,부인하다,무시하다,거부하다|SAT
admit|인정하다|인정하다,부인하다,거부하다,숨기다|SAT
concede|인정하다|인정하다,부인하다,거부하다,주장하다|SAT
confess|고백하다|고백하다,부인하다,숨기다,거부하다|SAT
avow|공언하다|공언하다,부인하다,숨기다,거부하다|SAT
profess|공언하다|공언하다,부인하다,숨기다,거부하다|SAT
declare|선언하다|선언하다,숨기다,부인하다,철회하다|SAT
proclaim|선포하다|선포하다,숨기다,부인하다,철회하다|SAT
announce|발표하다|발표하다,숨기다,철회하다,보류하다|SAT
promulgate|공표하다|공표하다,숨기다,철회하다,억제하다|SAT
broadcast|방송하다|방송하다,숨기다,억제하다,제한하다|SAT
publicize|공개하다|공개하다,숨기다,은폐하다,억제하다|SAT
divulge|누설하다|누설하다,숨기다,보호하다,비밀로하다|SAT
disclose|공개하다|공개하다,숨기다,은폐하다,보호하다|SAT
reveal|드러내다|드러내다,숨기다,은폐하다,가리다|SAT
expose|폭로하다|폭로하다,숨기다,보호하다,은폐하다|SAT
unveil|공개하다|공개하다,가리다,숨기다,은폐하다|SAT
uncover|드러내다|드러내다,덮다,숨기다,보호하다|SAT
unmask|정체를드러내다|정체를드러내다,숨기다,가장하다,보호하다|SAT