consequence|결과|결과,원인,시작,과정|TOEFL
cause|원인|원인,결과,영향,끝|TOEFL
effect|영향|영향,원인,시작,무관|TOEFL
result|결과|결과,원인,과정,시작|TOEFL
outcome|결과|결과,원인,시작,과정|TOEFL
influence|영향|영향,원인,무관,독립|TOEFL
impact|충격|충격,평화,안정,무관|TOEFL
factor|요인|요인,결과,영향,끝|TOEFL
element|요소|요소,전체,결과,완성|TOEFL
component|구성요소|구성요소,전체,결과,완성|TOEFL
aspect|측면|측면,전체,중심,끝|TOEFL
feature|특징|특징,결함,단점,문제|TOEFL
characteristic|특성|특성,결함,단점,일반성|TOEFL
quality|특성|특성,양,수량,결함|TOEFL
property|속성|속성,소유물,결과,영향|TOEFL
attribute|속성|속성,결함,단점,문제|TOEFL
trait|특징|특징,결함,일반성,평범함|TOEFL
nature|본질|본질,표면,외관,가식|TOEFL
essence|본질|본질,표면,외관,형식|TOEFL
substance|실체|실체,환상,가상,표면|TOEFL
material|재료|재료,완성품,결과,목적|TOEFL
matter|물질|물질,정신,영혼,추상|TOEFL
content|내용|내용,형식,외관,포장|TOEFL
form|형태|형태,내용,본질,실체|TOEFL
shape|모양|모양,내용,본질,실체|TOEFL
structure|구조|구조,내용,무질서,혼란|TOEFL
pattern|패턴|패턴,무작위,혼란,무질서|TOEFL
design|디자인|디자인,우연,무작위,혼란|TOEFL
style|스타일|스타일,내용,본질,실체|TOEFL
fashion|유행|유행,전통,고전,낡음|TOEFL
trend|경향|경향,전통,고정,안정|TOEFL
tendency|경향|경향,저항,반대,회피|TOEFL
inclination|성향|성향,혐오,거부,반대|TOEFL
preference|선호|선호,혐오,거부,무관심|TOEFL
choice|선택|선택,강제,의무,필수|TOEFL
option|선택권|선택권,강제,의무,필수|TOEFL
alternative|대안|대안,유일,필수,강제|TOEFL
possibility|가능성|가능성,불가능,필연,확실|TOEFL
opportunity|기회|기회,장애물,방해,불가능|TOEFL
chance|기회|기회,필연,확실,불가능|TOEFL
occasion|경우|경우,항상,필연,불가능|TOEFL
instance|사례|사례,원칙,규칙,전체|TOEFL
example|예|예,원칙,규칙,전체|TOEFL
case|경우|경우,원칙,규칙,항상|TOEFL
situation|상황|상황,원인,결과,해결책|TOEFL
circumstance|환경|환경,원인,결과,핵심|TOEFL
condition|조건|조건,결과,자유,무관|TOEFL
state|상태|상태,변화,과정,원인|TOEFL
status|지위|지위,과정,변화,평등|TOEFL
position|위치|위치,이동,변화,무관|TOEFL
location|위치|위치,이동,변화,무관|TOEFL
place|장소|장소,시간,사람,사물|TOEFL
site|장소|장소,시간,이동,변화|TOEFL
spot|지점|지점,전체,무관,이동|TOEFL
area|지역|지역,점,선,시간|TOEFL
region|지역|지역,중심,점,시간|TOEFL
zone|구역|구역,전체,중심,시간|TOEFL
district|구역|구역,전체,중심,국가|TOEFL
section|부분|부분,전체,통합,결합|TOEFL
part|부분|부분,전체,통합,완전|TOEFL
portion|부분|부분,전체,완전,통합|TOEFL
segment|부분|부분,전체,통합,완전|TOEFL
piece|조각|조각,전체,완전,통합|TOEFL
fragment|파편|파편,전체,완전,통합|TOEFL
fraction|분수|분수,전체,통합,완전|TOEFL
unit|단위|단위,전체,통합,결합|TOEFL
item|항목|항목,전체,통합,결합|TOEFL
object|대상|대상,주체,관찰자,행위자|TOEFL
subject|주제|주제,객체,결과,부차적|TOEFL
topic|주제|주제,세부,결과,부차적|TOEFL
theme|주제|주제,세부,부차적,결과|TOEFL
issue|문제|문제,해결책,답,성공|TOEFL
problem|문제|문제,해결책,답,성공|TOEFL
question|질문|질문,답,해결,확실|TOEFL
matter|문제|문제,해결,답,무관|TOEFL
concern|관심사|관심사,무관심,무시,거부|TOEFL
interest|관심|관심,무관심,혐오,지루함|TOEFL
attention|주의|주의,무관심,무시,방심|TOEFL
focus|초점|초점,분산,무관,주변|TOEFL
concentration|집중|집중,분산,무관심,혼란|TOEFL
emphasis|강조|강조,무시,최소화,경시|TOEFL
stress|강조|강조,완화,무시,경시|TOEFL
importance|중요성|중요성,사소함,무의미,무관|TOEFL
significance|중요성|중요성,사소함,무의미,무관|TOEFL
value|가치|가치,무가치,쓸모없음,해로움|TOEFL
worth|가치|가치,무가치,해로움,손해|TOEFL
merit|장점|장점,단점,결함,문제|TOEFL
advantage|이점|이점,단점,손해,불이익|TOEFL
benefit|이익|이익,손해,피해,불이익|TOEFL
profit|이익|이익,손실,손해,비용|TOEFL
gain|이득|이득,손실,손해,비용|TOEFL
loss|손실|손실,이익,이득,수익|TOEFL
damage|손해|손해,이익,수리,개선|TOEFL
harm|피해|피해,이익,도움,보호|TOEFL
injury|부상|부상,치료,건강,회복|TOEFL
hurt|상처|상처,치유,회복,건강|TOEFL
pain|고통|고통,기쁨,즐거움,편안함|TOEFL
suffering|고통|고통,행복,즐거움,편안함|TOEFL
distress|고민|고민,평화,안정,기쁨|TOEFL
trouble|곤란|곤란,도움,해결,평화|TOEFL
difficulty|어려움|어려움,쉬움,편안함,단순함|TOEFL
hardship|고난|고난,편안함,풍요,행복|TOEFL
challenge|도전|도전,쉬움,편안함,단순함|TOEFL
obstacle|장애물|장애물,도움,지원,통로|TOEFL
barrier|장벽|장벽,통로,다리,연결|TOEFL
hindrance|방해|방해,도움,지원,촉진|TOEFL
prevention|예방|예방,유발,촉진,허용|TOEFL
protection|보호|보호,위험,공격,방치|TOEFL
safety|안전|안전,위험,불안,공포|TOEFL
security|안보|안보,위험,불안,공격|TOEFL
danger|위험|위험,안전,보호,평화|TOEFL
risk|위험|위험,안전,확실,보장|TOEFL
threat|위협|위협,보호,안전,평화|TOEFL
menace|위협|위협,보호,안전,도움|TOEFL
peril|위험|위험,안전,보호,평화|TOEFL
hazard|위험|위험,안전,보호,편안함|TOEFL
crisis|위기|위기,안정,평화,번영|TOEFL
emergency|비상사태|비상사태,평상시,안정,평화|TOEFL
disaster|재난|재난,축복,행운,평화|TOEFL
catastrophe|대재앙|대재앙,축복,행운,번영|TOEFL
calamity|재앙|재앙,축복,행운,평화|TOEFL
tragedy|비극|비극,희극,행복,기쁨|TOEFL
misfortune|불행|불행,행운,축복,기쁨|TOEFL
fate|운명|운명,선택,자유,우연|TOEFL
destiny|운명|운명,선택,자유,우연|TOEFL
fortune|운|운,노력,계획,필연|TOEFL
luck|행운|행운,불운,노력,필연|TOEFL
success|성공|성공,실패,좌절,패배|TOEFL
achievement|성취|성취,실패,포기,좌절|TOEFL
accomplishment|업적|업적,실패,좌절,포기|TOEFL
victory|승리|승리,패배,항복,실패|TOEFL
triumph|승리|승리,패배,굴복,실패|TOEFL
defeat|패배|패배,승리,성공,달성|TOEFL
failure|실패|실패,성공,승리,달성|TOEFL
loss|패배|패배,승리,획득,성공|TOEFL
error|오류|오류,정확,진실,성공|TOEFL
mistake|실수|실수,정확,의도,성공|TOEFL
fault|잘못|잘못,정확,완벽,미덕|TOEFL
defect|결함|결함,완벽,장점,미덕|TOEFL
flaw|결점|결점,완벽,장점,미덕|TOEFL
weakness|약점|약점,강점,장점,힘|TOEFL
strength|강점|강점,약점,단점,결함|TOEFL
power|힘|힘,약함,무력,허약|TOEFL
force|힘|힘,약함,평화,온화|TOEFL
energy|에너지|에너지,무기력,피로,약함|TOEFL
capacity|능력|능력,무능,한계,불가능|TOEFL
ability|능력|능력,무능,불가능,한계|TOEFL
capability|역량|역량,무능,불가능,한계|TOEFL
skill|기술|기술,무능,서툼,미숙|TOEFL
talent|재능|재능,무능,평범,미숙|TOEFL
gift|재능|재능,무능,평범,저주|TOEFL
genius|천재성|천재성,어리석음,평범,무능|TOEFL
intelligence|지능|지능,어리석음,무지,둔함|TOEFL
wisdom|지혜|지혜,어리석음,무지,경솔|TOEFL
knowledge|지식|지식,무지,오해,혼란|TOEFL
information|정보|정보,무지,비밀,혼란|TOEFL
data|자료|자료,의견,추측,무지|TOEFL
fact|사실|사실,의견,거짓,추측|TOEFL
truth|진실|진실,거짓,의견,추측|TOEFL
reality|현실|현실,환상,꿈,가상|TOEFL
evidence|증거|증거,추측,의견,거짓|TOEFL
proof|증명|증명,의심,추측,거짓|TOEFL
demonstration|증명|증명,의심,숨김,거짓|TOEFL
illustration|예시|예시,추상,일반,전체|TOEFL
explanation|설명|설명,혼란,숨김,침묵|TOEFL
description|묘사|묘사,숨김,왜곡,침묵|TOEFL
definition|정의|정의,혼란,모호,불명확|TOEFL
meaning|의미|의미,무의미,혼란,모호|TOEFL
sense|의미|의미,무의미,혼란,어리석음|TOEFL
significance|의미|의미,무의미,사소함,무관|TOEFL
interpretation|해석|해석,오해,혼란,무지|TOEFL
understanding|이해|이해,오해,무지,혼란|TOEFL
comprehension|이해|이해,오해,무지,혼란|TOEFL
perception|인식|인식,무지,오해,혼란|TOEFL
recognition|인식|인식,무지,무시,혼란|TOEFL
awareness|인식|인식,무지,무시,무관심|TOEFL
consciousness|의식|의식,무의식,무지,혼수|TOEFL
thought|생각|생각,행동,무지,무의식|TOEFL
idea|아이디어|아이디어,사실,행동,무지|TOEFL
notion|개념|개념,사실,확실,증거|TOEFL
concept|개념|개념,사실,실제,구체|TOEFL
theory|이론|이론,사실,실제,증명|TOEFL
hypothesis|가설|가설,사실,증명,확실|TOEFL
assumption|가정|가정,사실,증명,확인|TOEFL
belief|믿음|믿음,의심,불신,확인|TOEFL
opinion|의견|의견,사실,증거,확실|TOEFL
view|견해|견해,사실,증거,맹목|TOEFL
perspective|관점|관점,사실,객관,편견|TOEFL
attitude|태도|태도,행동,사실,결과|TOEFL
approach|접근법|접근법,회피,무시,거부|TOEFL
method|방법|방법,결과,목적,우연|TOEFL
way|방법|방법,목적,결과,장애|TOEFL
manner|방식|방식,내용,목적,결과|TOEFL
means|수단|수단,목적,결과,장애|TOEFL
technique|기법|기법,결과,목적,우연|TOEFL
procedure|절차|절차,결과,혼란,우연|TOEFL
process|과정|과정,결과,시작,끝|TOEFL
system|체계|체계,혼란,무질서,우연|TOEFL
strategy|전략|전략,우연,즉흥,혼란|TOEFL
plan|계획|계획,우연,즉흥,혼란|TOEFL
scheme|계획|계획,우연,즉흥,혼란|TOEFL
project|프로젝트|프로젝트,결과,완성,우연|TOEFL
program|프로그램|프로그램,결과,우연,혼란|TOEFL
policy|정책|정책,우연,즉흥,혼란|TOEFL
rule|규칙|규칙,자유,혼란,무질서|TOEFL
regulation|규정|규정,자유,무질서,혼란|TOEFL
law|법|법,무법,혼란,자유|TOEFL
principle|원칙|원칙,예외,혼란,우연|TOEFL
standard|기준|기준,예외,무질서,자유|TOEFL
criterion|기준|기준,우연,무작위,혼란|TOEFL
measure|척도|척도,추측,우연,혼란|TOEFL
scale|척도|척도,무작위,혼란,우연|TOEFL
degree|정도|정도,무,전무,극단|TOEFL
level|수준|수준,평등,무,혼란|TOEFL
grade|등급|등급,평등,무차별,혼란|TOEFL
rank|순위|순위,평등,무차별,혼란|TOEFL
rate|비율|비율,전체,무,평등|TOEFL
ratio|비율|비율,전체,동일,평등|TOEFL
proportion|비율|비율,전체,평등,동일|TOEFL
percentage|백분율|백분율,전체,무,평등|TOEFL
amount|양|양,무,없음,질|TOEFL
quantity|양|양,질,무,없음|TOEFL
number|수|수,무수,무한,없음|TOEFL
figure|숫자|숫자,문자,이미지,없음|TOEFL
sum|합계|합계,차이,부분,없음|TOEFL
total|총계|총계,부분,일부,없음|TOEFL
whole|전체|전체,부분,일부,조각|TOEFL
entire|전체|전체,부분,일부,불완전|TOEFL
complete|완전한|완전한,불완전한,부분적인,결함있는|TOEFL
full|가득한|가득한,빈,부족한,불완전한|TOEFL
abundant|풍부한|풍부한,부족한,결핍된,빈약한|TOEFL
plentiful|풍부한|풍부한,부족한,희소한,결핍된|TOEFL
ample|충분한|충분한,부족한,불충분한,결핍된|TOEFL
sufficient|충분한|충분한,불충분한,부족한,결핍된|TOEFL
adequate|적절한|적절한,부족한,과도한,불충분한|TOEFL
proper|적절한|적절한,부적절한,틀린,잘못된|TOEFL
appropriate|적절한|적절한,부적절한,틀린,잘못된|TOEFL
suitable|적합한|적합한,부적합한,틀린,어울리지않는|TOEFL
fit|적합한|적합한,부적합한,틀린,어울리지않는|TOEFL
relevant|관련된|관련된,무관한,부적절한,반대의|TOEFL
related|관련된|관련된,무관한,독립적인,반대의|TOEFL
connected|연결된|연결된,분리된,독립적인,무관한|TOEFL
associated|관련된|관련된,무관한,분리된,독립적인|TOEFL
corresponding|상응하는|상응하는,반대되는,무관한,모순되는|TOEFL
equivalent|동등한|동등한,다른,불평등한,우월한|TOEFL
identical|동일한|동일한,다른,반대의,상이한|TOEFL
similar|유사한|유사한,다른,반대의,상이한|TOEFL
alike|유사한|유사한,다른,반대의,상이한|TOEFL
comparable|비슷한|비슷한,다른,반대의,무관한|TOEFL
parallel|평행한|평행한,교차하는,반대의,수직의|TOEFL
different|다른|다른,같은,동일한,유사한|TOEFL
distinct|구별되는|구별되는,동일한,유사한,혼합된|TOEFL
separate|분리된|분리된,연결된,통합된,결합된|TOEFL
independent|독립적인|독립적인,의존적인,관련된,종속적인|TOEFL
individual|개별적인|개별적인,집단적인,공동의,통합된|TOEFL
particular|특정한|특정한,일반적인,보편적인,전체의|TOEFL
specific|구체적인|구체적인,일반적인,추상적인,모호한|TOEFL
precise|정확한|정확한,부정확한,대략적인,모호한|TOEFL
exact|정확한|정확한,부정확한,대략적인,모호한|TOEFL
accurate|정확한|정확한,부정확한,틀린,잘못된|TOEFL
correct|올바른|올바른,틀린,잘못된,부정확한|TOEFL
right|올바른|올바른,틀린,잘못된,부정확한|TOEFL
true|진실한|진실한,거짓된,틀린,잘못된|TOEFL
genuine|진짜의|진짜의,가짜의,거짓된,위조된|TOEFL
authentic|진짜의|진짜의,가짜의,위조된,모방의|TOEFL
real|실제의|실제의,가짜의,상상의,거짓된|TOEFL
actual|실제의|실제의,가상의,이론적인,상상의|TOEFL
practical|실용적인|실용적인,이론적인,비현실적인,추상적인|TOEFL
realistic|현실적인|현실적인,비현실적인,이상적인,환상적인|TOEFL
reasonable|합리적인|합리적인,비합리적인,불합리한,터무니없는|TOEFL
sensible|분별있는|분별있는,어리석은,무분별한,터무니없는|TOEFL
rational|이성적인|이성적인,비이성적인,감정적인,충동적인|TOEFL
logical|논리적인|논리적인,비논리적인,불합리한,모순된|TOEFL
consistent|일관된|일관된,모순된,불일치한,변덕스러운|TOEFL
coherent|일관된|일관된,모순된,혼란스러운,무질서한|TOEFL
systematic|체계적인|체계적인,무질서한,혼란스러운,임의의|TOEFL
organized|조직된|조직된,무질서한,혼란스러운,흩어진|TOEFL
orderly|질서있는|질서있는,무질서한,혼란스러운,흩어진|TOEFL
neat|깔끔한|깔끔한,지저분한,혼란스러운,어지러운|TOEFL
tidy|정돈된|정돈된,지저분한,어지러운,혼란스러운|TOEFL
elaborate|정교한|정교한,단순한,조잡한,기본적인|TOEFL
intricate|복잡한|복잡한,단순한,쉬운,기본적인|TOEFL
complicated|복잡한|복잡한,단순한,쉬운,명확한|TOEFL
complex|복잡한|복잡한,단순한,쉬운,기본적인|TOEFL
sophisticated|세련된|세련된,조잡한,단순한,미숙한|TOEFL
advanced|진보된|진보된,후진적인,원시적인,낙후된|TOEFL
progressive|진보적인|진보적인,보수적인,후퇴적인,정체된|TOEFL
innovative|혁신적인|혁신적인,전통적인,보수적인,낡은|TOEFL
creative|창의적인|창의적인,모방적인,평범한,진부한|TOEFL
original|독창적인|독창적인,모방적인,복사된,진부한|TOEFL
novel|새로운|새로운,낡은,전통적인,진부한|TOEFL
fresh|신선한|신선한,낡은,상한,진부한|TOEFL
recent|최근의|최근의,오래된,과거의,옛날의|TOEFL
current|현재의|현재의,과거의,옛날의,미래의|TOEFL
contemporary|동시대의|동시대의,과거의,고대의,미래의|TOEFL
modern|현대적인|현대적인,고대의,전통적인,낡은|TOEFL
up-to-date|최신의|최신의,구식의,낡은,시대착오적인|TOEFL
obsolete|구식의|구식의,최신의,현대적인,유행하는|TOEFL
outdated|시대에뒤떨어진|시대에뒤떨어진,최신의,현대적인,유행하는|TOEFL
old-fashioned|구식의|구식의,현대적인,유행하는,최신의|TOEFL
ancient|고대의|고대의,현대적인,최신의,새로운|TOEFL
primitive|원시적인|원시적인,진보된,발전된,현대적인|TOEFL
establish|설립하다|설립하다,폐지하다,파괴하다,해체하다|SAT
found|설립하다|설립하다,폐지하다,파괴하다,해체하다|SAT
institute|제정하다|제정하다,폐지하다,취소하다,무효화하다|SAT
organize|조직하다|조직하다,해체하다,흩어지다,분산하다|SAT
form|형성하다|형성하다,파괴하다,해체하다,분해하다|SAT
constitute|구성하다|구성하다,파괴하다,해체하다,분해하다|SAT
compose|구성하다|구성하다,분해하다,파괴하다,흩어지다|SAT
comprise|구성하다|구성하다,제외하다,분리하다,배제하다|SAT
arrange|배열하다|배열하다,흩어지다,혼란시키다,뒤섞다|SAT
order|정돈하다|정돈하다,흩어지다,혼란시키다,어지럽히다|SAT
classify|분류하다|분류하다,혼합하다,섞다,무질서하게하다|SAT
categorize|분류하다|분류하다,혼합하다,통합하다,뒤섞다|SAT
sort|분류하다|분류하다,혼합하다,섞다,무질서하게하다|SAT
group|분류하다|분류하다,분산시키다,흩어지다,독립시키다|SAT
distinguish|구별하다|구별하다,혼동하다,혼합하다,일치시키다|SAT
differentiate|구별하다|구별하다,통합하다,혼동하다,일치시키다|SAT
discriminate|구별하다|구별하다,혼동하다,평등하게대하다,통합하다|SAT
discern|식별하다|식별하다,혼동하다,무시하다,놓치다|SAT
detect|탐지하다|탐지하다,놓치다,무시하다,숨기다|SAT
notice|알아차리다|알아차리다,놓치다,무시하다,간과하다|SAT
observe|관찰하다|관찰하다,무시하다,놓치다,피하다|SAT
perceive|인지하다|인지하다,무시하다,놓치다,오해하다|SAT
realize|깨닫다|깨닫다,모르다,무시하다,오해하다|SAT
recognize|인식하다|인식하다,무시하다,잊다,오해하다|SAT
acknowledge|인정하다|인정하다,부인하다,무시하다,거부하다|SAT
admit|인정하다|인정하다,부인하다,거부하다,숨기다|SAT
confess|고백하다|고백하다,부인하다,숨기다,거부하다|SAT
declare|선언하다|선언하다,숨기다,부인하다,취소하다|SAT
announce|발표하다|발표하다,숨기다,취소하다,보류하다|SAT
proclaim|선포하다|선포하다,숨기다,부인하다,취소하다|SAT
state|진술하다|진술하다,숨기다,부인하다,철회하다|SAT
assert|주장하다|주장하다,부인하다,의심하다,철회하다|SAT
claim|주장하다|주장하다,부인하다,포기하다,양보하다|SAT
maintain|주장하다|주장하다,부인하다,포기하다,철회하다|SAT
insist|주장하다|주장하다,양보하다,포기하다,부인하다|SAT
argue|주장하다|주장하다,동의하다,양보하다,침묵하다|SAT
debate|토론하다|토론하다,동의하다,침묵하다,회피하다|SAT
discuss|논의하다|논의하다,무시하다,침묵하다,회피하다|SAT
dispute|논쟁하다|논쟁하다,동의하다,합의하다,화해하다|SAT
contradict|모순되다|모순되다,일치하다,확인하다,지지하다|SAT
oppose|반대하다|반대하다,지지하다,찬성하다,동의하다|SAT
resist|저항하다|저항하다,받아들이다,순응하다,항복하다|SAT
object|반대하다|반대하다,찬성하다,지지하다,동의하다|SAT
protest|항의하다|항의하다,찬성하다,수락하다,동의하다|SAT
challenge|도전하다|도전하다,받아들이다,순응하다,항복하다|SAT
defy|거역하다|거역하다,복종하다,순응하다,따르다|SAT
disobey|거역하다|거역하다,복종하다,따르다,순응하다|SAT
violate|위반하다|위반하다,준수하다,따르다,지키다|SAT
break|어기다|어기다,지키다,준수하다,따르다|SAT
infringe|침해하다|침해하다,보호하다,존중하다,지키다|SAT
offend|모욕하다|모욕하다,존중하다,칭찬하다,기쁘게하다|SAT
insult|모욕하다|모욕하다,칭찬하다,존중하다,격려하다|SAT
humiliate|굴욕감을주다|굴욕감을주다,격려하다,칭찬하다,존중하다|SAT
embarrass|당황시키다|당황시키다,안심시키다,격려하다,편안하게하다|SAT
shame|수치심을주다|수치심을주다,자랑스럽게하다,칭찬하다,격려하다|SAT
disgrace|욕되게하다|욕되게하다,명예롭게하다,칭찬하다,존중하다|SAT
dishonor|불명예스럽게하다|불명예스럽게하다,명예롭게하다,칭찬하다,존중하다|SAT
degrade|저하시키다|저하시키다,향상시키다,개선하다,높이다|SAT
demote|강등시키다|강등시키다,승진시키다,높이다,올리다|SAT
lower|낮추다|낮추다,올리다,높이다,승진시키다|SAT
reduce|줄이다|줄이다,증가시키다,늘리다,확대하다|SAT
decrease|감소시키다|감소시키다,증가시키다,늘리다,확대하다|SAT
diminish|줄이다|줄이다,증가시키다,확대하다,강화하다|SAT
lessen|줄이다|줄이다,증가시키다,늘리다,강화하다|SAT
minimize|최소화하다|최소화하다,최대화하다,증가시키다,확대하다|SAT
weaken|약화시키다|약화시키다,강화하다,튼튼하게하다,높이다|SAT
undermine|약화시키다|약화시키다,강화하다,지지하다,돕다|SAT
impair|손상시키다|손상시키다,개선하다,강화하다,회복시키다|SAT
damage|손상시키다|손상시키다,수리하다,개선하다,복구하다|SAT
harm|해치다|해치다,돕다,보호하다,치료하다|SAT
hurt|다치게하다|다치게하다,치료하다,보호하다,돕다|SAT
injure|다치게하다|다치게하다,치료하다,회복시키다,보호하다|SAT
wound|상처입히다|상처입히다,치료하다,치유하다,보호하다|SAT
afflict|괴롭히다|괴롭히다,위로하다,치료하다,돕다|SAT
torment|괴롭히다|괴롭히다,위로하다,진정시키다,돕다|SAT
torture|고문하다|고문하다,위로하다,돕다,보호하다|SAT
persecute|박해하다|박해하다,보호하다,돕다,지지하다|SAT
oppress|억압하다|억압하다,해방하다,자유롭게하다,돕다|SAT
suppress|억압하다|억압하다,장려하다,자유롭게하다,표현하다|SAT
repress|억압하다|억압하다,표현하다,해방하다,장려하다|SAT
restrain|억제하다|억제하다,장려하다,자유롭게하다,풀어주다|SAT
restrict|제한하다|제한하다,확대하다,자유롭게하다,허용하다|SAT
limit|제한하다|제한하다,확대하다,늘리다,자유롭게하다|SAT
confine|제한하다|제한하다,자유롭게하다,확대하다,풀어주다|SAT
constrain|강제하다|강제하다,자유롭게하다,허용하다,선택하게하다|SAT
compel|강요하다|강요하다,허용하다,선택하게하다,자유롭게하다|SAT
force|강요하다|강요하다,허용하다,자유롭게하다,선택하게하다|SAT
coerce|강요하다|강요하다,설득하다,허용하다,자유롭게하다|SAT
oblige|의무를지우다|의무를지우다,면제하다,허용하다,자유롭게하다|SAT
require|요구하다|요구하다,면제하다,허용하다,선택하게하다|SAT
demand|요구하다|요구하다,제공하다,허용하다,양보하다|SAT
request|요청하다|요청하다,거부하다,명령하다,강요하다|SAT
ask|부탁하다|부탁하다,명령하다,거부하다,강요하다|SAT
beg|애원하다|애원하다,명령하다,거부하다,강요하다|SAT
plead|간청하다|간청하다,명령하다,거부하다,강요하다|SAT
implore|간청하다|간청하다,명령하다,거부하다,요구하다|SAT
entreat|간청하다|간청하다,명령하다,요구하다,거부하다|SAT
appeal|호소하다|호소하다,명령하다,거부하다,강요하다|SAT
petition|청원하다|청원하다,명령하다,거부하다,강요하다|SAT
apply|신청하다|신청하다,취소하다,거부하다,철회하다|SAT
nominate|지명하다|지명하다,거부하다,해고하다,배제하다|SAT
appoint|임명하다|임명하다,해고하다,거부하다,파면하다|SAT
designate|지정하다|지정하다,해제하다,거부하다,제외하다|SAT
assign|할당하다|할당하다,제거하다,거부하다,철회하다|SAT
allocate|배분하다|배분하다,회수하다,빼앗다,제거하다|SAT
distribute|분배하다|분배하다,모으다,집중하다,독점하다|SAT
dispense|분배하다|분배하다,모으다,독점하다,보관하다|SAT
issue|발급하다|발급하다,회수하다,취소하다,거부하다|SAT
grant|부여하다|부여하다,거부하다,박탈하다,철회하다|SAT
confer|수여하다|수여하다,박탈하다,거부하다,회수하다|SAT
bestow|수여하다|수여하다,박탈하다,빼앗다,거부하다|SAT
award|수여하다|수여하다,박탈하다,거부하다,회수하다|SAT
present|증정하다|증정하다,거부하다,빼앗다,회수하다|SAT
donate|기부하다|기부하다,받다,빼앗다,회수하다|SAT
contribute|기부하다|기부하다,받다,빼앗다,거부하다|SAT
subscribe|구독하다|구독하다,취소하다,거부하다,중단하다|SAT
enroll|등록하다|등록하다,탈퇴하다,취소하다,거부하다|SAT
register|등록하다|등록하다,취소하다,삭제하다,거부하다|SAT
join|가입하다|가입하다,탈퇴하다,거부하다,떠나다|SAT
participate|참여하다|참여하다,관찰하다,거부하다,피하다|SAT
engage|참여하다|참여하다,피하다,관찰하다,거부하다|SAT
involve|포함시키다|포함시키다,제외하다,배제하다,거부하다|SAT
incorporate|통합하다|통합하다,분리하다,제외하다,독립시키다|SAT
integrate|통합하다|통합하다,분리하다,독립시키다,배제하다|SAT
merge|합병하다|합병하다,분리하다,독립하다,나누다|SAT
combine|결합하다|결합하다,분리하다,나누다,독립하다|SAT
unite|연합하다|연합하다,분리하다,독립하다,나누다|SAT
ally|동맹하다|동맹하다,적대하다,분리하다,독립하다|SAT
associate|연합하다|연합하다,분리하다,독립하다,배제하다|SAT
affiliate|제휴하다|제휴하다,분리하다,독립하다,배제하다|SAT
cooperate|협력하다|협력하다,경쟁하다,방해하다,거부하다|SAT
collaborate|협업하다|협업하다,경쟁하다,방해하다,독립하다|SAT
coordinate|조정하다|조정하다,방해하다,혼란시키다,독립하다|SAT
synchronize|동시화하다|동시화하다,엇갈리게하다,방해하다,분리하다|SAT
harmonize|조화시키다|조화시키다,충돌하게하다,방해하다,분리하다|SAT
balance|균형잡다|균형잡다,불균형하게하다,기울이다,무너뜨리다|SAT
equalize|균등하게하다|균등하게하다,차별하다,불평등하게하다,분리하다|SAT
standardize|표준화하다|표준화하다,다양화하다,차별화하다,분리하다|SAT
normalize|정상화하다|정상화하다,비정상화하다,혼란시키다,악화시키다|SAT
regulate|규제하다|규제하다,자유롭게하다,무질서하게하다,혼란시키다|SAT
control|통제하다|통제하다,자유롭게하다,풀어주다,포기하다|SAT
govern|통치하다|통치하다,해방하다,자유롭게하다,혼란시키다|SAT
rule|지배하다|지배하다,복종하다,해방하다,자유롭게하다|SAT
dominate|지배하다|지배하다,복종하다,해방하다,평등하게하다|SAT
command|지휘하다|지휘하다,복종하다,따르다,순응하다|SAT
direct|지휘하다|지휘하다,따르다,복종하다,순응하다|SAT
manage|관리하다|관리하다,방치하다,무시하다,포기하다|SAT
administer|관리하다|관리하다,방치하다,무시하다,포기하다|SAT
supervise|감독하다|감독하다,무시하다,방치하다,자유롭게하다|SAT
oversee|감독하다|감독하다,무시하다,방치하다,포기하다|SAT
monitor|감시하다|감시하다,무시하다,방치하다,자유롭게하다|SAT
inspect|검사하다|검사하다,무시하다,방치하다,승인하다|SAT
examine|조사하다|조사하다,무시하다,간과하다,승인하다|SAT
investigate|조사하다|조사하다,무시하다,숨기다,방치하다|SAT
explore|탐구하다|탐구하다,무시하다,피하다,방치하다|SAT
probe|조사하다|조사하다,무시하다,숨기다,피하다|SAT
scrutinize|정밀조사하다|정밀조사하다,간과하다,무시하다,승인하다|SAT
analyze|분석하다|분석하다,무시하다,통합하다,간과하다|SAT
evaluate|평가하다|평가하다,무시하다,추측하다,승인하다|SAT
assess|평가하다|평가하다,무시하다,추측하다,거부하다|SAT
estimate|추정하다|추정하다,확인하다,무시하다,거부하다|SAT
calculate|계산하다|계산하다,추측하다,무시하다,거부하다|SAT
measure|측정하다|측정하다,추측하다,무시하다,거부하다|SAT
gauge|측정하다|측정하다,추측하다,무시하다,간과하다|SAT
determine|결정하다|결정하다,의심하다,포기하다,혼란스러워하다|SAT
decide|결정하다|결정하다,망설이다,포기하다,의심하다|SAT
resolve|결심하다|결심하다,망설이다,포기하다,의심하다|SAT
settle|해결하다|해결하다,악화시키다,혼란시키다,포기하다|SAT
solve|해결하다|해결하다,악화시키다,만들다,복잡하게하다|SAT
clarify|명확히하다|명확히하다,혼란시키다,모호하게하다,숨기다|SAT
elucidate|설명하다|설명하다,혼란시키다,숨기다,모호하게하다|SAT
interpret|해석하다|해석하다,오해하다,혼란시키다,무시하다|SAT
translate|번역하다|번역하다,왜곡하다,오해하다,무시하다|SAT
convert|변환하다|변환하다,유지하다,보존하다,고정하다|SAT
transform|변형하다|변형하다,유지하다,보존하다,고정하다|SAT
alter|변경하다|변경하다,유지하다,보존하다,고정하다|SAT
modify|수정하다|수정하다,유지하다,보존하다,고정하다|SAT
adjust|조정하다|조정하다,고정하다,유지하다,방치하다|SAT
adapt|적응시키다|적응시키다,거부하다,저항하다,고정하다|SAT
accommodate|수용하다|수용하다,거부하다,배제하다,저항하다|SAT
conform|순응하다|순응하다,저항하다,거부하다,반항하다|SAT
comply|따르다|따르다,거역하다,거부하다,저항하다|SAT
obey|복종하다|복종하다,거역하다,저항하다,반항하다|SAT
yield|양보하다|양보하다,저항하다,거부하다,주장하다|SAT
submit|복종하다|복종하다,저항하다,반항하다,거부하다|SAT
surrender|항복하다|항복하다,저항하다,싸우다,거부하다|SAT
concede|양보하다|양보하다,주장하다,거부하다,저항하다|SAT
grant|인정하다|인정하다,부인하다,거부하다,저항하다|SAT
allow|허용하다|허용하다,금지하다,거부하다,막다|SAT
permit|허가하다|허가하다,금지하다,거부하다,막다|SAT
authorize|승인하다|승인하다,금지하다,거부하다,철회하다|SAT
approve|승인하다|승인하다,거부하다,불허하다,반대하다|SAT
sanction|승인하다|승인하다,금지하다,처벌하다,거부하다|SAT
endorse|지지하다|지지하다,반대하다,거부하다,비난하다|SAT
support|지지하다|지지하다,반대하다,방해하다,거부하다|SAT
advocate|옹호하다|옹호하다,반대하다,비난하다,공격하다|SAT
promote|촉진하다|촉진하다,방해하다,억제하다,금지하다|SAT
encourage|격려하다|격려하다,낙담시키다,방해하다,금지하다|SAT
stimulate|자극하다|자극하다,억제하다,진정시키다,방해하다|SAT
motivate|동기부여하다|동기부여하다,낙담시키다,억제하다,방해하다|SAT
inspire|영감을주다|영감을주다,낙담시키다,억제하다,지루하게하다|SAT
urge|촉구하다|촉구하다,말리다,억제하다,금지하다|SAT
persuade|설득하다|설득하다,말리다,의심하게하다,거부하다|SAT
convince|확신시키다|확신시키다,의심하게하다,혼란시키다,거부하다|SAT