ambivalent|양가감정의|양가감정의,확신있는,명확한,단호한|TOEFL
indecisive|우유부단한|우유부단한,단호한,결단력있는,확고한|TOEFL
tentative|잠정적인|잠정적인,확정적인,최종적인,영구적인|TOEFL
provisional|임시의|임시의,영구적인,확정적인,최종적인|TOEFL
transient|일시적인|일시적인,영구적인,지속적인,안정적인|TOEFL
ephemeral|덧없는|덧없는,영원한,지속적인,영구적인|TOEFL
fleeting|순간적인|순간적인,영구적인,지속적인,오래가는|TOEFL
momentary|순간적인|순간적인,영구적인,지속적인,장기적인|TOEFL
transitory|일시적인|일시적인,영구적인,지속적인,안정적인|TOEFL
evanescent|사라지기쉬운|사라지기쉬운,영구적인,지속적인,안정적인|TOEFL
volatile|변덕스러운|변덕스러운,안정적인,일관된,예측가능한|TOEFL
unstable|불안정한|불안정한,안정적인,확고한,견고한|TOEFL
precarious|불안정한|불안정한,안전한,확실한,안정적인|TOEFL
vulnerable|취약한|취약한,강한,안전한,보호된|TOEFL
susceptible|민감한|민감한,저항력있는,면역된,보호된|TOEFL
prone|~하기쉬운|~하기쉬운,저항력있는,면역된,회피하는|TOEFL
apt|~하는경향이있는|~하는경향이있는,~하지않는,저항하는,회피하는|TOEFL
liable|~하기쉬운|~하기쉬운,면역된,보호된,회피하는|TOEFL
inclined|경향이있는|경향이있는,꺼리는,저항하는,회피하는|TOEFL
disposed|~할마음이있는|~할마음이있는,꺼리는,거부하는,저항하는|TOEFL
predisposed|소질이있는|소질이있는,면역된,저항력있는,무관심한|TOEFL
biased|편향된|편향된,공정한,중립적인,객관적인|TOEFL
prejudiced|편견있는|편견있는,공정한,객관적인,중립적인|TOEFL
partial|편파적인|편파적인,공정한,중립적인,객관적인|TOEFL
impartial|공정한|공정한,편파적인,편향된,불공정한|TOEFL
objective|객관적인|객관적인,주관적인,편향된,편파적인|TOEFL
subjective|주관적인|주관적인,객관적인,공정한,중립적인|TOEFL
arbitrary|임의적인|임의적인,합리적인,체계적인,논리적인|TOEFL
capricious|변덕스러운|변덕스러운,일관된,예측가능한,안정적인|TOEFL
whimsical|변덕스러운|변덕스러운,일관된,진지한,논리적인|TOEFL
erratic|불규칙한|불규칙한,일정한,규칙적인,예측가능한|TOEFL
inconsistent|일관성없는|일관성없는,일관된,규칙적인,안정적인|TOEFL
sporadic|산발적인|산발적인,규칙적인,일정한,지속적인|TOEFL
intermittent|간헐적인|간헐적인,지속적인,일정한,규칙적인|TOEFL
periodic|주기적인|주기적인,불규칙한,무작위의,지속적인|TOEFL
cyclical|주기적인|주기적인,불규칙한,일정한,직선적인|TOEFL
recurrent|반복적인|반복적인,일회성의,유일한,새로운|TOEFL
repetitive|반복적인|반복적인,다양한,독특한,새로운|TOEFL
redundant|중복된|중복된,필수적인,독특한,유일한|TOEFL
superfluous|불필요한|불필요한,필수적인,중요한,부족한|TOEFL
extraneous|무관한|무관한,관련된,필수적인,중요한|TOEFL
irrelevant|무관한|무관한,관련된,중요한,필수적인|TOEFL
tangential|주제에서벗어난|주제에서벗어난,핵심적인,관련된,중요한|TOEFL
peripheral|주변적인|주변적인,중심적인,핵심적인,중요한|TOEFL
marginal|한계의|한계의,중심적인,주요한,필수적인|TOEFL
incidental|부수적인|부수적인,주요한,핵심적인,필수적인|TOEFL
ancillary|보조적인|보조적인,주요한,핵심적인,필수적인|TOEFL
subsidiary|보조적인|보조적인,주요한,중심적인,독립적인|TOEFL
complementary|보완적인|보완적인,반대되는,모순되는,대립적인|TOEFL
supplementary|보충적인|보충적인,주요한,핵심적인,기본적인|TOEFL
collateral|부수적인|부수적인,주요한,핵심적인,직접적인|TOEFL
concurrent|동시발생하는|동시발생하는,순차적인,이전의,이후의|TOEFL
simultaneous|동시의|동시의,순차적인,이전의,이후의|TOEFL
synchronous|동시의|동시의,비동기적인,순차적인,불일치하는|TOEFL
coexistent|공존하는|공존하는,배타적인,독립적인,분리된|TOEFL
concomitant|동반하는|동반하는,독립적인,무관한,분리된|TOEFL
attendant|수반하는|수반하는,독립적인,무관한,분리된|TOEFL
correlative|상관관계의|상관관계의,무관한,독립적인,반대되는|TOEFL
reciprocal|상호의|상호의,일방적인,독립적인,무관한|TOEFL
mutual|상호의|상호의,일방적인,독립적인,개인적인|TOEFL
bilateral|쌍방의|쌍방의,일방적인,독립적인,다자간의|TOEFL
multilateral|다자간의|다자간의,일방적인,쌍방의,독립적인|TOEFL
unilateral|일방적인|일방적인,쌍방의,상호의,다자간의|TOEFL
unanimous|만장일치의|만장일치의,분열된,의견이갈리는,반대하는|TOEFL
consensus|합의의|합의의,분열된,논쟁적인,의견불일치의|TOEFL
collective|집단적인|집단적인,개인적인,독립적인,분리된|TOEFL
communal|공동의|공동의,개인적인,사적인,독립적인|TOEFL
corporate|단체의|단체의,개인적인,독립적인,분리된|TOEFL
aggregate|집합적인|집합적인,개별적인,분리된,독립적인|TOEFL
cumulative|누적적인|누적적인,개별적인,순간적인,일시적인|TOEFL
comprehensive|포괄적인|포괄적인,제한적인,부분적인,선택적인|TOEFL
inclusive|포괄적인|포괄적인,배타적인,제한적인,선택적인|TOEFL
exclusive|배타적인|배타적인,포괄적인,개방적인,공유하는|TOEFL
selective|선택적인|선택적인,포괄적인,무차별적인,전체적인|TOEFL
discriminating|식별력있는|식별력있는,무차별적인,무분별한,관대한|TOEFL
fastidious|까다로운|까다로운,관대한,무차별적인,수용적인|TOEFL
meticulous|세심한|세심한,대충하는,부주의한,무관심한|TOEFL
scrupulous|꼼꼼한|꼼꼼한,부주의한,대충하는,무책임한|TOEFL
punctilious|세심한|세심한,대충하는,무관심한,무책임한|TOEFL
exacting|엄격한|엄격한,관대한,너그러운,느슨한|TOEFL
rigorous|엄격한|엄격한,관대한,느슨한,부주의한|TOEFL
stringent|엄격한|엄격한,관대한,느슨한,자유로운|TOEFL
austere|엄격한|엄격한,관대한,사치스러운,풍족한|TOEFL
stern|엄격한|엄격한,관대한,친절한,온화한|TOEFL
severe|가혹한|가혹한,관대한,온화한,부드러운|TOEFL
harsh|가혹한|가혹한,온화한,부드러운,관대한|TOEFL
rigid|경직된|경직된,유연한,관대한,적응적인|TOEFL
inflexible|완고한|완고한,유연한,적응적인,관대한|TOEFL
adamant|단호한|단호한,유연한,관대한,양보하는|TOEFL
obstinate|완고한|완고한,유연한,적응적인,순응적인|TOEFL
stubborn|고집센|고집센,유연한,순응적인,협력적인|TOEFL
intransigent|타협하지않는|타협하지않는,유연한,협력적인,양보하는|TOEFL
recalcitrant|반항적인|반항적인,순종하는,협력적인,온순한|TOEFL
refractory|다루기힘든|다루기힘든,순종하는,협력적인,온순한|TOEFL
unruly|통제불가능한|통제불가능한,순종하는,규율있는,온순한|TOEFL
wayward|제멋대로인|제멋대로인,순종하는,예측가능한,규율있는|TOEFL
perverse|심술궂은|심술궂은,친절한,협력적인,순종하는|TOEFL
contrary|반대의|반대의,일치하는,동의하는,협력하는|TOEFL
opposite|반대의|반대의,같은,유사한,일치하는|TOEFL
antithetical|정반대의|정반대의,유사한,일치하는,보완적인|TOEFL
contradictory|모순된|모순된,일치하는,일관된,조화로운|TOEFL
incompatible|양립불가능한|양립불가능한,조화로운,일치하는,호환되는|TOEFL
incongruous|부조화한|부조화한,조화로운,일치하는,어울리는|TOEFL
discordant|불협화음의|불협화음의,조화로운,일치하는,화음의|TOEFL
dissonant|불협화음의|불협화음의,조화로운,화음의,일치하는|TOEFL
cacophonous|불협화음의|불협화음의,조화로운,아름다운,화음의|TOEFL
harmonious|조화로운|조화로운,불협화음의,불일치하는,충돌하는|TOEFL
melodious|선율적인|선율적인,불협화음의,거슬리는,소음같은|TOEFL
euphonious|듣기좋은|듣기좋은,불쾌한,거슬리는,소음같은|TOEFL
sonorous|울려퍼지는|울려퍼지는,조용한,약한,무음의|TOEFL
resonant|울려퍼지는|울려퍼지는,약한,조용한,무음의|TOEFL
reverberant|반향하는|반향하는,조용한,흡음하는,무음의|TOEFL
resounding|울려퍼지는|울려퍼지는,조용한,약한,희미한|TOEFL
emphatic|강조하는|강조하는,약한,애매한,불명확한|TOEFL
pronounced|두드러진|두드러진,미약한,희미한,불분명한|TOEFL
conspicuous|눈에띄는|눈에띄는,눈에안띄는,숨겨진,미묘한|TOEFL
prominent|현저한|현저한,미미한,숨겨진,사소한|TOEFL
salient|두드러진|두드러진,미미한,사소한,부차적인|TOEFL
striking|인상적인|인상적인,평범한,눈에안띄는,사소한|TOEFL
remarkable|주목할만한|주목할만한,평범한,사소한,무의미한|TOEFL
notable|주목할만한|주목할만한,평범한,사소한,무의미한|TOEFL
noteworthy|주목할만한|주목할만한,평범한,사소한,무의미한|TOEFL
distinguished|저명한|저명한,무명의,평범한,무의미한|TOEFL
eminent|저명한|저명한,무명의,평범한,무의미한|TOEFL
illustrious|저명한|저명한,무명의,평범한,불명예스러운|TOEFL
prestigious|명망있는|명망있는,무명의,평판나쁜,천한|TOEFL
renowned|유명한|유명한,무명의,알려지지않은,평범한|TOEFL
celebrated|유명한|유명한,무명의,알려지지않은,무시되는|TOEFL
acclaimed|호평받는|호평받는,비난받는,무시되는,무명의|TOEFL
esteemed|존경받는|존경받는,경멸받는,무시되는,무명의|TOEFL
venerable|존경할만한|존경할만한,경멸스러운,무가치한,젊은|TOEFL
revered|숭배되는|숭배되는,경멸받는,무시되는,모독되는|TOEFL
hallowed|신성한|신성한,모독된,평범한,세속적인|TOEFL
sacred|신성한|신성한,세속적인,모독된,평범한|TOEFL
consecrated|신성한|신성한,모독된,세속적인,평범한|TOEFL
sanctified|신성화된|신성화된,모독된,세속적인,평범한|TOEFL
divine|신성한|신성한,악마적인,평범한,세속적인|TOEFL
celestial|천상의|천상의,세속적인,지상의,평범한|TOEFL
ethereal|천상의|천상의,세속적인,현실적인,물질적인|TOEFL
sublime|숭고한|숭고한,저속한,평범한,비천한|TOEFL
transcendent|초월적인|초월적인,평범한,세속적인,물질적인|TOEFL
supernatural|초자연적인|초자연적인,자연적인,평범한,현실적인|TOEFL
mystical|신비로운|신비로운,평범한,명확한,현실적인|TOEFL
enigmatic|수수께끼같은|수수께끼같은,명확한,분명한,이해하기쉬운|TOEFL
cryptic|수수께끼같은|수수께끼같은,명확한,분명한,명백한|TOEFL
arcane|신비로운|신비로운,명확한,널리알려진,일반적인|TOEFL
esoteric|난해한|난해한,명확한,쉬운,대중적인|TOEFL
abstruse|난해한|난해한,명확한,쉬운,단순한|TOEFL
recondite|난해한|난해한,명확한,쉬운,널리알려진|TOEFL
obscure|모호한|모호한,명확한,분명한,유명한|TOEFL
ambiguous|애매한|애매한,명확한,분명한,확실한|TOEFL
equivocal|애매한|애매한,명확한,단정적인,확실한|TOEFL
nebulous|모호한|모호한,명확한,분명한,구체적인|TOEFL
indefinite|불명확한|불명확한,명확한,확정적인,구체적인|TOEFL
indeterminate|불확정적인|불확정적인,확정적인,명확한,결정된|TOEFL
elusive|파악하기어려운|파악하기어려운,명확한,잡기쉬운,분명한|TOEFL
intangible|무형의|무형의,유형의,구체적인,실체있는|TOEFL
impalpable|감지할수없는|감지할수없는,명백한,만질수있는,구체적인|TOEFL
imperceptible|감지할수없는|감지할수없는,명백한,뚜렷한,분명한|TOEFL
inconspicuous|눈에띄지않는|눈에띄지않는,눈에띄는,명백한,두드러진|TOEFL
unobtrusive|눈에띄지않는|눈에띄지않는,눈에띄는,돋보이는,두드러진|TOEFL
subtle|미묘한|미묘한,명백한,노골적인,두드러진|TOEFL
nuanced|미묘한차이가있는|미묘한차이가있는,명백한,단순한,극명한|TOEFL
delicate|섬세한|섬세한,거친,조잡한,둔감한|TOEFL
refined|세련된|세련된,조잡한,거친,저속한|TOEFL
sophisticated|세련된|세련된,단순한,조잡한,순진한|TOEFL
urbane|세련된|세련된,촌스러운,거친,무례한|TOEFL
suave|세련된|세련된,거친,무례한,투박한|TOEFL
debonair|우아한|우아한,거친,무례한,어색한|TOEFL
genteel|품위있는|품위있는,저속한,거친,무례한|TOEFL
courteous|예의바른|예의바른,무례한,거친,버릇없는|TOEFL
civil|예의바른|예의바른,무례한,거친,야만적인|TOEFL
polite|공손한|공손한,무례한,버릇없는,거친|TOEFL
gracious|정중한|정중한,무례한,불친절한,거친|TOEFL
cordial|친절한|친절한,냉담한,적대적인,무례한|TOEFL
amiable|친절한|친절한,불친절한,적대적인,냉담한|TOEFL
affable|상냥한|상냥한,무뚝뚝한,냉담한,거친|TOEFL
genial|다정한|다정한,냉담한,무뚝뚝한,불친절한|TOEFL
congenial|마음맞는|마음맞는,맞지않는,불쾌한,적대적인|TOEFL
convivial|쾌활한|쾌활한,우울한,무뚝뚝한,냉담한|TOEFL
gregarious|사교적인|사교적인,내성적인,고립된,외로운|TOEFL
sociable|사교적인|사교적인,내성적인,비사교적인,고립된|TOEFL
outgoing|외향적인|외향적인,내성적인,수줍은,소극적인|TOEFL
extroverted|외향적인|외향적인,내향적인,수줍은,고립된|TOEFL
vivacious|활발한|활발한,무기력한,우울한,조용한|TOEFL
exuberant|열정적인|열정적인,무기력한,냉담한,우울한|TOEFL
ebullient|열정적인|열정적인,침울한,무기력한,냉담한|TOEFL
effervescent|발랄한|발랄한,침울한,무기력한,우울한|TOEFL
buoyant|명랑한|명랑한,침울한,우울한,무기력한|TOEFL
spirited|기운찬|기운찬,무기력한,침울한,지친|TOEFL
animated|활기찬|활기찬,무기력한,생기없는,지친|TOEFL
lively|활기찬|활기찬,무기력한,침울한,지루한|TOEFL
vigorous|활발한|활발한,약한,무기력한,지친|TOEFL
energetic|활동적인|활동적인,무기력한,지친,느린|TOEFL
dynamic|역동적인|역동적인,정적인,무기력한,수동적인|TOEFL
robust|강건한|강건한,약한,허약한,병약한|TOEFL
sturdy|튼튼한|튼튼한,약한,허약한,연약한|TOEFL
stalwart|강건한|강건한,약한,망설이는,동요하는|TOEFL
stout|튼튼한|튼튼한,약한,허약한,마른|TOEFL
hardy|강인한|강인한,연약한,허약한,섬세한|TOEFL
resilient|탄력있는|탄력있는,약한,부러지기쉬운,허약한|TOEFL
durable|내구성있는|내구성있는,약한,일시적인,부서지기쉬운|TOEFL
enduring|오래가는|오래가는,일시적인,순간적인,짧은|TOEFL
lasting|지속적인|지속적인,일시적인,순간적인,짧은|TOEFL
perpetual|영구적인|영구적인,일시적인,짧은,끝나는|TOEFL
perennial|영속적인|영속적인,일시적인,계절적인,짧은|TOEFL
incessant|끊임없는|끊임없는,간헐적인,일시적인,드문|TOEFL
unremitting|끊임없는|끊임없는,간헐적인,일시적인,완화되는|TOEFL
relentless|가차없는|가차없는,자비로운,완화되는,관대한|TOEFL
inexorable|막을수없는|막을수없는,막을수있는,유연한,관대한|TOEFL
implacable|달랠수없는|달랠수없는,달랠수있는,유연한,관대한|TOEFL
unyielding|굽히지않는|굽히지않는,유연한,양보하는,관대한|TOEFL
adamant|단호한|단호한,유연한,우유부단한,양보하는|TOEFL
resolute|단호한|단호한,우유부단한,동요하는,약한|TOEFL
steadfast|확고한|확고한,동요하는,불안정한,변덕스러운|TOEFL
unwavering|흔들리지않는|흔들리지않는,동요하는,우유부단한,불안정한|TOEFL
staunch|충실한|충실한,배신하는,동요하는,불충실한|TOEFL
loyal|충성스러운|충성스러운,배신하는,불충실한,변절하는|TOEFL
faithful|충실한|충실한,배신하는,불충실한,변절하는|TOEFL
devoted|헌신적인|헌신적인,무관심한,소홀한,배신하는|TOEFL
dedicated|헌신적인|헌신적인,무관심한,태만한,소홀한|TOEFL
committed|전념하는|전념하는,무관심한,소홀한,망설이는|TOEFL
zealous|열정적인|열정적인,무관심한,냉담한,소극적인|TOEFL
fervent|열렬한|열렬한,냉담한,무관심한,차갑게|TOEFL
ardent|열렬한|열렬한,냉담한,무관심한,차가운|TOEFL
passionate|열정적인|열정적인,냉담한,무관심한,차가운|TOEFL
vehement|격렬한|격렬한,온화한,차분한,냉담한|TOEFL
intense|강렬한|강렬한,약한,온화한,차분한|TOEFL
profound|깊은|깊은,얕은,피상적인,가벼운|TOEFL
penetrating|꿰뚫는|꿰뚫는,피상적인,얕은,둔한|TOEFL
incisive|예리한|예리한,둔한,피상적인,애매한|TOEFL
acute|날카로운|날카로운,둔한,무딘,무감각한|TOEFL
keen|예리한|예리한,둔한,무딘,무관심한|TOEFL
astute|영리한|영리한,어리석은,둔한,무지한|TOEFL
shrewd|빈틈없는|빈틈없는,순진한,어리석은,둔한|TOEFL
perspicacious|통찰력있는|통찰력있는,둔감한,어리석은,무지한|TOEFL
discerning|식별력있는|식별력있는,무분별한,둔감한,무지한|TOEFL
judicious|분별있는|분별있는,무분별한,어리석은,경솔한|TOEFL
prudent|신중한|신중한,무모한,경솔한,무분별한|TOEFL
circumspect|신중한|신중한,무모한,경솔한,부주의한|TOEFL
wary|조심스러운|조심스러운,무모한,대담한,부주의한|TOEFL
cautious|조심스러운|조심스러운,무모한,대담한,경솔한|TOEFL
vigilant|경계하는|경계하는,방심하는,부주의한,무관심한|TOEFL
watchful|주의깊은|주의깊은,부주의한,방심하는,무관심한|TOEFL
alert|경계하는|경계하는,방심하는,둔한,졸린|TOEFL
attentive|주의깊은|주의깊은,부주의한,무관심한,산만한|TOEFL
heedful|유념하는|유념하는,무관심한,부주의한,망각하는|TOEFL
mindful|유념하는|유념하는,무관심한,망각하는,부주의한|TOEFL
cognizant|인식하는|인식하는,무지한,무의식적인,무관심한|TOEFL
aware|인식하는|인식하는,무지한,모르는,무의식적인|TOEFL
conscious|의식하는|의식하는,무의식적인,무지한,모르는|TOEFL
deliberate|신중한|신중한,경솔한,우연한,무의식적인|TOEFL
intentional|의도적인|의도적인,우연한,무의식적인,실수의|TOEFL
premeditated|계획적인|계획적인,즉흥적인,우연한,무의식적인|TOEFL
calculated|계산된|계산된,즉흥적인,무모한,우연한|TOEFL
methodical|체계적인|체계적인,무질서한,즉흥적인,무작위의|TOEFL
systematic|체계적인|체계적인,무질서한,무작위의,혼란스러운|TOEFL
orderly|질서있는|질서있는,무질서한,혼란스러운,무작위의|TOEFL
organized|조직적인|조직적인,무질서한,혼란스러운,즉흥적인|TOEFL
meticulous|세심한|세심한,대충하는,부주의한,무관심한|TOEFL
scrupulous|꼼꼼한|꼼꼼한,대충하는,부주의한,부정직한|TOEFL
painstaking|공들인|공들인,대충하는,서두르는,부주의한|TOEFL
thorough|철저한|철저한,대충하는,피상적인,불완전한|TOEFL
comprehensive|포괄적인|포괄적인,제한적인,부분적인,불완전한|TOEFL
exhaustive|철저한|철저한,불완전한,피상적인,선택적인|TOEFL
elaborate|정교한|정교한,단순한,조잡한,기본적인|TOEFL
intricate|복잡한|복잡한,단순한,쉬운,기본적인|TOEFL
complicated|복잡한|복잡한,단순한,쉬운,명확한|TOEFL
convoluted|복잡한|복잡한,단순한,명확한,직선적인|TOEFL
labyrinthine|미로같은|미로같은,단순한,명확한,직선적인|TOEFL
byzantine|복잡한|복잡한,단순한,명확한,투명한|TOEFL
articulate|분명히말하다|분명히말하다,중얼거리다,애매하게말하다,침묵하다|SAT
enunciate|명확히발음하다|명확히발음하다,중얼거리다,불명확하게말하다,침묵하다|SAT
elucidate|명확히하다|명확히하다,혼란시키다,모호하게하다,숨기다|SAT
explicate|설명하다|설명하다,혼란시키다,애매하게하다,숨기다|SAT
expound|상세히설명하다|상세히설명하다,간략히말하다,숨기다,침묵하다|SAT
elaborate|상세히설명하다|상세히설명하다,간략히하다,요약하다,숨기다|SAT
amplify|상세히설명하다|상세히설명하다,축소하다,요약하다,줄이다|SAT
embellish|장식하다|장식하다,단순화하다,제거하다,줄이다|SAT
ornament|장식하다|장식하다,제거하다,단순화하다,벗기다|SAT
adorn|꾸미다|꾸미다,벗기다,제거하다,단순화하다|SAT
garnish|장식하다|장식하다,제거하다,벗기다,단순화하다|SAT
emblazon|장식하다|장식하다,제거하다,숨기다,지우다|SAT
illuminate|밝히다|밝히다,어둡게하다,가리다,숨기다|SAT
enlighten|계몽하다|계몽하다,혼란시키다,무지하게하다,속이다|SAT
edify|교화하다|교화하다,타락시키다,혼란시키다,무지하게하다|SAT
instruct|가르치다|가르치다,무지하게하다,혼란시키다,속이다|SAT
educate|교육하다|교육하다,무지하게하다,오도하다,방치하다|SAT
cultivate|교양을쌓다|교양을쌓다,무지하게하다,타락시키다,방치하다|SAT
refine|세련되게하다|세련되게하다,조잡하게하다,타락시키다,거칠게하다|SAT
polish|다듬다|다듬다,거칠게하다,손상시키다,조잡하게하다|SAT
hone|연마하다|연마하다,무디게하다,손상시키다,약화시키다|SAT
sharpen|날카롭게하다|날카롭게하다,무디게하다,약화시키다,손상시키다|SAT
accentuate|강조하다|강조하다,약화시키다,최소화하다,숨기다|SAT
emphasize|강조하다|강조하다,최소화하다,무시하다,숨기다|SAT
underscore|강조하다|강조하다,최소화하다,무시하다,약화시키다|SAT
highlight|강조하다|강조하다,최소화하다,숨기다,무시하다|SAT
accentuate|두드러지게하다|두드러지게하다,감추다,최소화하다,약화시키다|SAT
magnify|확대하다|확대하다,축소하다,최소화하다,줄이다|SAT
amplify|증폭하다|증폭하다,약화시키다,축소하다,억제하다|SAT
intensify|강화하다|강화하다,약화시키다,완화하다,줄이다|SAT
augment|증가시키다|증가시키다,감소시키다,줄이다,약화시키다|SAT
enhance|향상시키다|향상시키다,저하시키다,악화시키다,손상시키다|SAT
elevate|높이다|높이다,낮추다,저하시키다,떨어뜨리다|SAT
exalt|높이다|높이다,낮추다,격하시키다,비하하다|SAT
glorify|찬양하다|찬양하다,비하하다,모욕하다,비난하다|SAT
extol|칭송하다|칭송하다,비난하다,비하하다,모욕하다|SAT
laud|찬양하다|찬양하다,비난하다,비하하다,모욕하다|SAT
eulogize|찬양하다|찬양하다,비난하다,조롱하다,비하하다|SAT
commend|칭찬하다|칭찬하다,비난하다,꾸짖다,모욕하다|SAT
applaud|박수를보내다|박수를보내다,비난하다,야유하다,조롱하다|SAT
acclaim|갈채를보내다|갈채를보내다,비난하다,조롱하다,무시하다|SAT
celebrate|찬양하다|찬양하다,애도하다,비난하다,무시하다|SAT
commemorate|기념하다|기념하다,잊다,무시하다,폐기하다|SAT
venerate|존경하다|존경하다,경멸하다,모욕하다,무시하다|SAT
revere|숭배하다|숭배하다,경멸하다,모독하다,무시하다|SAT
worship|숭배하다|숭배하다,경멸하다,모독하다,저주하다|SAT
adore|숭배하다|숭배하다,혐오하다,경멸하다,저주하다|SAT
idolize|우상화하다|우상화하다,경멸하다,비하하다,무시하다|SAT
deify|신격화하다|신격화하다,비하하다,인간화하다,모독하다|SAT
sanctify|신성화하다|신성화하다,모독하다,저주하다,더럽히다|SAT
consecrate|봉헌하다|봉헌하다,모독하다,저주하다,더럽히다|SAT
hallow|신성하게하다|신성하게하다,모독하다,저주하다,더럽히다|SAT
bless|축복하다|축복하다,저주하다,비난하다,모독하다|SAT
bestow|수여하다|수여하다,박탈하다,빼앗다,거부하다|SAT
confer|수여하다|수여하다,박탈하다,거부하다,철회하다|SAT
grant|부여하다|부여하다,거부하다,박탈하다,철회하다|SAT
accord|부여하다|부여하다,거부하다,박탈하다,부인하다|SAT
endow|부여하다|부여하다,박탈하다,빼앗다,제거하다|SAT
invest|부여하다|부여하다,박탈하다,제거하다,철회하다|SAT
delegate|위임하다|위임하다,보유하다,철회하다,거부하다|SAT
entrust|맡기다|맡기다,불신하다,거부하다,철회하다|SAT
commission|위임하다|위임하다,해임하다,철회하다,거부하다|SAT
authorize|권한을주다|권한을주다,금지하다,거부하다,철회하다|SAT
empower|권한을주다|권한을주다,무력하게하다,금지하다,제한하다|SAT
enable|가능하게하다|가능하게하다,막다,금지하다,방해하다|SAT
facilitate|용이하게하다|용이하게하다,방해하다,막다,복잡하게하다|SAT
expedite|촉진하다|촉진하다,지연시키다,방해하다,막다|SAT
accelerate|가속화하다|가속화하다,지연시키다,늦추다,막다|SAT
hasten|서두르다|서두르다,지연시키다,늦추다,방해하다|SAT
precipitate|촉진하다|촉진하다,지연시키다,방해하다,억제하다|SAT
impel|촉구하다|촉구하다,억제하다,방해하다,막다|SAT
propel|추진하다|추진하다,막다,방해하다,억제하다|SAT
spur|자극하다|자극하다,억제하다,방해하다,막다|SAT
stimulate|자극하다|자극하다,억제하다,진정시키다,방해하다|SAT
galvanize|자극하다|자극하다,억제하다,마비시키다,진정시키다|SAT
energize|활력을주다|활력을주다,지치게하다,약화시키다,억제하다|SAT
invigorate|활기를주다|활기를주다,지치게하다,약화시키다,무기력하게하다|SAT
animate|활기를주다|활기를주다,무기력하게하다,지치게하다,죽이다|SAT
vitalize|활력을주다|활력을주다,죽이다,약화시키다,고갈시키다|SAT
rejuvenate|활력을되찾게하다|활력을되찾게하다,노쇠하게하다,약화시키다,지치게하다|SAT
revitalize|재활성화하다|재활성화하다,약화시키다,고갈시키다,죽이다|SAT
regenerate|재생하다|재생하다,파괴하다,퇴화시키다,약화시키다|SAT
renew|갱신하다|갱신하다,만료시키다,폐기하다,파괴하다|SAT
restore|회복시키다|회복시키다,파괴하다,악화시키다,손상시키다|SAT
reinstate|복원하다|복원하다,폐지하다,제거하다,철회하다|SAT
rehabilitate|재활시키다|재활시키다,손상시키다,악화시키다,파괴하다|SAT
recuperate|회복하다|회복하다,악화되다,쇠약해지다,병들다|SAT
convalesce|회복하다|회복하다,악화되다,병들다,쇠약해지다|SAT
revive|소생시키다|소생시키다,죽이다,약화시키다,억제하다|SAT
resuscitate|소생시키다|소생시키다,죽이다,질식시키다,억제하다|SAT
resurrect|부활시키다|부활시키다,죽이다,매장하다,파괴하다|SAT
reanimate|소생시키다|소생시키다,죽이다,무기력하게하다,억제하다|SAT
revivify|되살리다|되살리다,죽이다,약화시키다,억제하다|SAT
reinvigorate|재활성화하다|재활성화하다,약화시키다,억제하다,지치게하다|SAT
rekindle|다시불붙이다|다시불붙이다,끄다,억제하다,진정시키다|SAT
reignite|다시점화하다|다시점화하다,끄다,소화하다,억제하다|SAT
reawaken|다시깨우다|다시깨우다,재우다,진정시키다,억제하다|SAT
arouse|불러일으키다|불러일으키다,진정시키다,억제하다,숨기다|SAT
awaken|깨우다|깨우다,재우다,진정시키다,억제하다|SAT
evoke|불러일으키다|불러일으키다,억제하다,숨기다,진정시키다|SAT
elicit|끌어내다|끌어내다,억제하다,숨기다,막다|SAT
provoke|유발하다|유발하다,진정시키다,억제하다,막다|SAT
incite|선동하다|선동하다,진정시키다,억제하다,막다|SAT
instigate|선동하다|선동하다,억제하다,진정시키다,막다|SAT
foment|선동하다|선동하다,진정시키다,억제하다,평화롭게하다|SAT
kindle|불붙이다|불붙이다,끄다,억제하다,진정시키다|SAT
ignite|점화하다|점화하다,끄다,소화하다,억제하다|SAT
inflame|격앙시키다|격앙시키다,진정시키다,억제하다,완화하다|SAT
enflame|격앙시키다|격앙시키다,진정시키다,억제하다,완화하다|SAT
exacerbate|악화시키다|악화시키다,완화하다,개선하다,치료하다|SAT
aggravate|악화시키다|악화시키다,완화하다,개선하다,치료하다|SAT
worsen|악화시키다|악화시키다,개선하다,완화하다,치료하다|SAT
deteriorate|악화되다|악화되다,개선되다,회복되다,향상되다|SAT
degenerate|퇴화하다|퇴화하다,발전하다,개선되다,진보하다|SAT
decline|쇠퇴하다|쇠퇴하다,번영하다,개선되다,발전하다|SAT
wane|쇠퇴하다|쇠퇴하다,증가하다,번영하다,발전하다|SAT
diminish|감소하다|감소하다,증가하다,확대되다,강화되다|SAT
dwindle|줄어들다|줄어들다,증가하다,확대되다,번성하다|SAT
ebb|쇠퇴하다|쇠퇴하다,증가하다,밀려오다,번성하다|SAT
recede|물러나다|물러나다,전진하다,증가하다,다가오다|SAT
subside|가라앉다|가라앉다,증가하다,격화되다,상승하다|SAT
abate|완화되다|완화되다,악화되다,격화되다,증가하다|SAT
moderate|완화되다|완화되다,악화되다,격화되다,증가하다|SAT
temper|완화하다|완화하다,악화시키다,격화시키다,자극하다|SAT
mitigate|완화하다|완화하다,악화시키다,격화시키다,증가시키다|SAT
alleviate|완화하다|완화하다,악화시키다,증가시키다,격화시키다|SAT
assuage|완화하다|완화하다,악화시키다,자극하다,격화시키다|SAT
mollify|달래다|달래다,화나게하다,자극하다,격앙시키다|SAT
placate|달래다|달래다,화나게하다,자극하다,도발하다|SAT
appease|달래다|달래다,화나게하다,도발하다,자극하다|SAT
pacify|진정시키다|진정시키다,자극하다,격앙시키다,도발하다|SAT
conciliate|달래다|달래다,적대시하다,도발하다,화나게하다|SAT
propitiate|달래다|달래다,화나게하다,도발하다,적대시하다|SAT
soothe|달래다|달래다,자극하다,격앙시키다,화나게하다|SAT
calm|진정시키다|진정시키다,흥분시키다,자극하다,격앙시키다|SAT
tranquilize|진정시키다|진정시키다,흥분시키다,자극하다,격앙시키다|SAT
sedate|진정시키다|진정시키다,흥분시키다,자극하다,활성화시키다|SAT
lull|달래다|달래다,자극하다,흥분시키다,각성시키다|SAT
quell|진압하다|진압하다,선동하다,자극하다,격려하다|SAT
suppress|억압하다|억압하다,장려하다,자극하다,표현하다|SAT
subdue|제압하다|제압하다,격려하다,자극하다,해방하다|SAT
subjugate|정복하다|정복하다,해방하다,독립시키다,격려하다|SAT
vanquish|정복하다|정복하다,패배하다,항복하다,해방하다|SAT
conquer|정복하다|정복하다,항복하다,패배하다,해방하다|SAT
overcome|극복하다|극복하다,굴복하다,항복하다,패배하다|SAT
surmount|극복하다|극복하다,항복하다,굴복하다,패배하다|SAT
prevail|이기다|이기다,지다,항복하다,패배하다|SAT
triumph|승리하다|승리하다,패배하다,항복하다,실패하다|SAT
dominate|지배하다|지배하다,굴복하다,복종하다,항복하다|SAT
predominate|우세하다|우세하다,열등하다,뒤지다,굴복하다|SAT
transcend|초월하다|초월하다,제한되다,국한되다,굴복하다|SAT
surpass|능가하다|능가하다,뒤지다,열등하다,못미치다|SAT
exceed|초과하다|초과하다,못미치다,부족하다,제한되다|SAT
eclipse|능가하다|능가하다,뒤지다,열등하다,드러나다|SAT
overshadow|가리다|가리다,드러내다,밝히다,강조하다|SAT
outshine|능가하다|능가하다,뒤지다,희미해지다,열등하다|SAT
excel|뛰어나다|뛰어나다,뒤지다,실패하다,열등하다|SAT
distinguish|구별하다|구별하다,혼동하다,혼합하다,동일시하다|SAT
differentiate|구별하다|구별하다,통합하다,혼동하다,동일시하다|SAT
discern|식별하다|식별하다,혼동하다,놓치다,무시하다|SAT
discriminate|구별하다|구별하다,혼동하다,동일시하다,통합하다|SAT
demarcate|구분하다|구분하다,통합하다,혼합하다,결합하다|SAT
delineate|서술하다|서술하다,모호하게하다,혼란시키다,숨기다|SAT
depict|묘사하다|묘사하다,숨기다,왜곡하다,모호하게하다|SAT
portray|묘사하다|묘사하다,왜곡하다,숨기다,모호하게하다|SAT
characterize|특징짓다|특징짓다,왜곡하다,오해하다,모호하게하다|SAT
typify|전형적으로나타내다|전형적으로나타내다,예외이다,비정상이다,왜곡하다|SAT
exemplify|예시하다|예시하다,모순되다,반대되다,숨기다|SAT
epitomize|전형이되다|전형이되다,예외이다,비정상이다,모순되다|SAT
embody|구현하다|구현하다,모순되다,배제하다,분리하다|SAT
incarnate|구현하다|구현하다,분리하다,추상화하다,배제하다|SAT
personify|의인화하다|의인화하다,비인간화하다,추상화하다,일반화하다|SAT
encapsulate|요약하다|요약하다,확대하다,상세히하다,분산시키다|SAT
summarize|요약하다|요약하다,상세히하다,확대하다,반복하다|SAT
recapitulate|요약하다|요약하다,상세히하다,확대하다,반복하다|SAT
synopsize|개요를작성하다|개요를작성하다,상세히하다,확대하다,반복하다|SAT
abridge|요약하다|요약하다,확대하다,상세히하다,연장하다|SAT
condense|압축하다|압축하다,확대하다,희석하다,연장하다|SAT
abbreviate|축약하다|축약하다,확대하다,연장하다,상세히하다|SAT
truncate|자르다|자르다,연장하다,확대하다,완성하다|SAT
curtail|줄이다|줄이다,확대하다,연장하다,증가시키다|SAT
contract|축소하다|축소하다,확대하다,연장하다,증가하다|SAT
compress|압축하다|압축하다,확대하다,팽창시키다,느슨하게하다|SAT
constrict|수축시키다|수축시키다,확대하다,이완시키다,팽창시키다|SAT
constrain|제약하다|제약하다,해방하다,확대하다,자유롭게하다|SAT
restrict|제한하다|제한하다,확대하다,해방하다,허용하다|SAT
confine|제한하다|제한하다,해방하다,확대하다,자유롭게하다|SAT
circumscribe|제한하다|제한하다,확대하다,해방하다,허용하다|SAT
delimit|한계를정하다|한계를정하다,확대하다,무한정하다,자유롭게하다|SAT
demarcate|경계를정하다|경계를정하다,통합하다,확대하다,무한정하다|SAT